//MAP CONVERTED BY dmm2tgm.py THIS HEADER COMMENT PREVENTS RECONVERSION, DO NOT REMOVE
"sN" = (
/obj/effect/landmark/nightmare{
	insert_tag = "maintemple"
	},
/turf/template_noop,
/area/template_noop)
"tk" = (
/obj/structure/machinery/computer/nuke_disk_generator/red,
/turf/template_noop,
/area/template_noop)
"Ai" = (
/obj/structure/machinery/nuclearbomb/crash,
/turf/template_noop,
/area/template_noop)
"ZX" = (
/turf/template_noop,
/area/template_noop)

(1,1,1) = {"
ZX
ZX
ZX
ZX
ZX
ZX
ZX
ZX
ZX
ZX
ZX
ZX
ZX
ZX
ZX
ZX
ZX
ZX
ZX
ZX
ZX
ZX
ZX
ZX
ZX
ZX
ZX
ZX
ZX
ZX
ZX
ZX
ZX
ZX
ZX
ZX
ZX
ZX
ZX
sN
"}
(2,1,1) = {"
ZX
ZX
ZX
ZX
ZX
ZX
ZX
ZX
ZX
ZX
ZX
ZX
ZX
ZX
ZX
ZX
ZX
ZX
ZX
ZX
ZX
ZX
ZX
ZX
ZX
ZX
ZX
ZX
ZX
ZX
ZX
ZX
ZX
ZX
ZX
ZX
ZX
ZX
ZX
ZX
"}
(3,1,1) = {"
ZX
ZX
ZX
ZX
ZX
ZX
ZX
ZX
ZX
ZX
ZX
ZX
ZX
ZX
ZX
ZX
ZX
ZX
ZX
ZX
ZX
ZX
ZX
ZX
ZX
ZX
ZX
ZX
ZX
ZX
ZX
ZX
ZX
tk
ZX
ZX
ZX
ZX
ZX
ZX
"}
(4,1,1) = {"
ZX
ZX
ZX
ZX
ZX
ZX
ZX
ZX
ZX
ZX
ZX
ZX
ZX
ZX
ZX
ZX
ZX
ZX
ZX
ZX
ZX
ZX
ZX
ZX
ZX
ZX
ZX
ZX
ZX
ZX
ZX
ZX
ZX
ZX
ZX
ZX
ZX
ZX
ZX
ZX
"}
(5,1,1) = {"
ZX
ZX
ZX
ZX
ZX
ZX
ZX
ZX
ZX
ZX
ZX
ZX
ZX
ZX
ZX
ZX
ZX
ZX
ZX
ZX
ZX
ZX
ZX
ZX
ZX
ZX
ZX
ZX
ZX
ZX
ZX
ZX
ZX
ZX
ZX
ZX
ZX
ZX
ZX
ZX
"}
(6,1,1) = {"
ZX
ZX
ZX
ZX
ZX
ZX
ZX
ZX
ZX
ZX
ZX
ZX
ZX
ZX
ZX
ZX
ZX
ZX
ZX
ZX
ZX
ZX
ZX
ZX
ZX
ZX
ZX
ZX
ZX
ZX
ZX
ZX
ZX
ZX
ZX
ZX
ZX
ZX
ZX
ZX
"}
(7,1,1) = {"
ZX
ZX
ZX
ZX
ZX
ZX
ZX
ZX
ZX
ZX
ZX
ZX
ZX
ZX
ZX
ZX
ZX
ZX
ZX
ZX
ZX
ZX
ZX
ZX
ZX
ZX
ZX
ZX
ZX
ZX
ZX
ZX
ZX
ZX
ZX
ZX
ZX
ZX
ZX
ZX
"}
(8,1,1) = {"
ZX
ZX
ZX
ZX
ZX
ZX
ZX
ZX
ZX
ZX
ZX
ZX
ZX
ZX
ZX
ZX
ZX
ZX
ZX
ZX
ZX
ZX
ZX
ZX
ZX
ZX
ZX
ZX
ZX
ZX
ZX
ZX
ZX
ZX
ZX
ZX
ZX
ZX
ZX
ZX
"}
(9,1,1) = {"
ZX
ZX
ZX
ZX
ZX
ZX
ZX
ZX
ZX
ZX
ZX
ZX
ZX
ZX
ZX
ZX
ZX
ZX
ZX
ZX
ZX
ZX
ZX
ZX
ZX
ZX
ZX
ZX
ZX
ZX
ZX
ZX
ZX
ZX
ZX
ZX
ZX
ZX
ZX
ZX
"}
(10,1,1) = {"
ZX
ZX
ZX
ZX
ZX
ZX
ZX
ZX
ZX
ZX
ZX
ZX
ZX
ZX
ZX
ZX
ZX
ZX
ZX
ZX
ZX
ZX
ZX
ZX
ZX
ZX
ZX
ZX
ZX
ZX
ZX
ZX
ZX
ZX
ZX
ZX
ZX
ZX
ZX
ZX
"}
(11,1,1) = {"
ZX
ZX
ZX
ZX
ZX
ZX
ZX
ZX
ZX
ZX
ZX
ZX
ZX
ZX
ZX
ZX
ZX
ZX
ZX
ZX
ZX
ZX
ZX
ZX
ZX
ZX
ZX
ZX
ZX
ZX
ZX
ZX
ZX
ZX
ZX
ZX
ZX
ZX
ZX
ZX
"}
(12,1,1) = {"
ZX
ZX
ZX
ZX
ZX
ZX
ZX
ZX
ZX
ZX
ZX
ZX
ZX
ZX
ZX
ZX
ZX
ZX
ZX
ZX
ZX
ZX
ZX
ZX
ZX
ZX
ZX
ZX
ZX
ZX
ZX
ZX
ZX
ZX
ZX
ZX
ZX
ZX
ZX
ZX
"}
(13,1,1) = {"
ZX
ZX
ZX
ZX
ZX
ZX
ZX
ZX
ZX
ZX
ZX
ZX
ZX
ZX
ZX
ZX
ZX
ZX
ZX
ZX
ZX
ZX
ZX
ZX
ZX
ZX
ZX
ZX
ZX
ZX
ZX
ZX
ZX
ZX
ZX
ZX
ZX
ZX
ZX
ZX
"}
(14,1,1) = {"
ZX
ZX
ZX
ZX
ZX
ZX
ZX
ZX
ZX
ZX
ZX
ZX
ZX
ZX
ZX
ZX
ZX
ZX
ZX
ZX
ZX
ZX
ZX
ZX
ZX
ZX
ZX
ZX
ZX
ZX
ZX
ZX
ZX
ZX
ZX
ZX
ZX
ZX
ZX
ZX
"}
(15,1,1) = {"
ZX
ZX
ZX
ZX
ZX
ZX
ZX
ZX
ZX
ZX
ZX
ZX
ZX
ZX
ZX
ZX
ZX
ZX
ZX
ZX
ZX
ZX
ZX
ZX
ZX
ZX
ZX
ZX
ZX
ZX
ZX
ZX
ZX
ZX
ZX
ZX
ZX
ZX
ZX
ZX
"}
(16,1,1) = {"
ZX
ZX
ZX
ZX
ZX
ZX
ZX
ZX
ZX
ZX
ZX
ZX
ZX
ZX
ZX
ZX
ZX
ZX
ZX
ZX
ZX
ZX
ZX
ZX
ZX
ZX
ZX
ZX
ZX
ZX
ZX
ZX
ZX
ZX
ZX
ZX
ZX
ZX
ZX
ZX
"}
(17,1,1) = {"
ZX
ZX
ZX
ZX
ZX
ZX
ZX
ZX
ZX
ZX
ZX
ZX
ZX
ZX
ZX
ZX
ZX
ZX
ZX
ZX
ZX
ZX
ZX
ZX
ZX
ZX
ZX
ZX
ZX
ZX
ZX
ZX
ZX
ZX
ZX
ZX
ZX
ZX
ZX
ZX
"}
(18,1,1) = {"
ZX
ZX
ZX
ZX
ZX
ZX
ZX
ZX
ZX
ZX
ZX
ZX
ZX
ZX
ZX
ZX
ZX
ZX
ZX
ZX
ZX
ZX
ZX
ZX
ZX
ZX
ZX
ZX
ZX
ZX
ZX
ZX
ZX
ZX
ZX
ZX
ZX
ZX
ZX
ZX
"}
(19,1,1) = {"
ZX
ZX
ZX
ZX
ZX
ZX
ZX
ZX
ZX
ZX
ZX
ZX
ZX
ZX
ZX
ZX
ZX
ZX
ZX
ZX
ZX
ZX
ZX
ZX
ZX
ZX
ZX
ZX
ZX
ZX
ZX
ZX
ZX
ZX
ZX
ZX
ZX
ZX
ZX
ZX
"}
(20,1,1) = {"
ZX
ZX
ZX
ZX
ZX
ZX
ZX
ZX
ZX
ZX
ZX
ZX
ZX
ZX
ZX
ZX
ZX
ZX
ZX
ZX
ZX
ZX
ZX
ZX
ZX
ZX
ZX
ZX
ZX
ZX
ZX
ZX
ZX
ZX
ZX
ZX
ZX
ZX
ZX
ZX
"}
(21,1,1) = {"
ZX
ZX
ZX
ZX
ZX
ZX
ZX
ZX
ZX
ZX
ZX
ZX
ZX
ZX
ZX
ZX
ZX
ZX
ZX
ZX
ZX
ZX
ZX
ZX
ZX
ZX
ZX
ZX
ZX
ZX
ZX
ZX
ZX
ZX
ZX
ZX
ZX
ZX
ZX
ZX
"}
(22,1,1) = {"
ZX
ZX
ZX
ZX
ZX
ZX
ZX
ZX
ZX
ZX
ZX
ZX
ZX
ZX
ZX
ZX
ZX
ZX
ZX
ZX
ZX
ZX
ZX
ZX
ZX
ZX
ZX
ZX
ZX
ZX
ZX
ZX
ZX
ZX
ZX
ZX
ZX
ZX
ZX
ZX
"}
(23,1,1) = {"
ZX
ZX
ZX
ZX
ZX
ZX
ZX
ZX
ZX
ZX
ZX
ZX
ZX
ZX
ZX
ZX
ZX
ZX
ZX
ZX
ZX
ZX
ZX
ZX
ZX
ZX
ZX
ZX
ZX
ZX
ZX
ZX
ZX
ZX
ZX
ZX
ZX
ZX
ZX
ZX
"}
(24,1,1) = {"
ZX
ZX
ZX
ZX
ZX
ZX
ZX
ZX
ZX
ZX
ZX
ZX
ZX
ZX
ZX
ZX
ZX
ZX
ZX
ZX
ZX
ZX
ZX
ZX
ZX
ZX
ZX
ZX
ZX
ZX
ZX
ZX
ZX
ZX
ZX
ZX
ZX
ZX
ZX
ZX
"}
(25,1,1) = {"
ZX
ZX
ZX
ZX
ZX
ZX
ZX
ZX
ZX
ZX
ZX
ZX
ZX
ZX
ZX
ZX
ZX
ZX
ZX
ZX
ZX
ZX
ZX
ZX
ZX
ZX
ZX
ZX
ZX
ZX
ZX
ZX
ZX
ZX
ZX
ZX
ZX
ZX
ZX
ZX
"}
(26,1,1) = {"
ZX
ZX
ZX
ZX
ZX
ZX
ZX
ZX
ZX
ZX
ZX
ZX
ZX
ZX
ZX
ZX
ZX
ZX
ZX
ZX
ZX
ZX
ZX
ZX
ZX
ZX
ZX
ZX
ZX
ZX
ZX
ZX
ZX
ZX
ZX
ZX
ZX
ZX
ZX
ZX
"}
(27,1,1) = {"
ZX
ZX
ZX
ZX
ZX
ZX
ZX
ZX
ZX
ZX
ZX
ZX
ZX
ZX
ZX
ZX
ZX
ZX
ZX
ZX
ZX
ZX
ZX
ZX
ZX
ZX
ZX
ZX
ZX
ZX
ZX
ZX
ZX
ZX
ZX
ZX
ZX
ZX
ZX
ZX
"}
(28,1,1) = {"
ZX
ZX
ZX
ZX
ZX
ZX
ZX
ZX
ZX
ZX
ZX
ZX
ZX
ZX
ZX
ZX
ZX
ZX
ZX
ZX
ZX
ZX
ZX
ZX
ZX
ZX
ZX
ZX
ZX
ZX
ZX
ZX
ZX
ZX
ZX
ZX
ZX
ZX
ZX
ZX
"}
(29,1,1) = {"
ZX
ZX
ZX
ZX
ZX
ZX
ZX
ZX
ZX
ZX
ZX
ZX
ZX
ZX
ZX
ZX
ZX
ZX
ZX
ZX
ZX
ZX
ZX
ZX
ZX
ZX
ZX
ZX
ZX
ZX
ZX
ZX
ZX
ZX
ZX
ZX
ZX
ZX
ZX
ZX
"}
(30,1,1) = {"
ZX
ZX
ZX
ZX
ZX
ZX
ZX
ZX
ZX
ZX
ZX
ZX
ZX
ZX
ZX
ZX
ZX
ZX
ZX
ZX
ZX
ZX
ZX
ZX
ZX
ZX
ZX
ZX
ZX
ZX
ZX
ZX
ZX
ZX
ZX
ZX
ZX
ZX
ZX
ZX
"}
(31,1,1) = {"
ZX
ZX
ZX
ZX
ZX
ZX
ZX
ZX
ZX
ZX
ZX
ZX
ZX
ZX
ZX
ZX
ZX
ZX
ZX
ZX
ZX
ZX
ZX
ZX
ZX
ZX
ZX
ZX
ZX
ZX
ZX
ZX
ZX
ZX
ZX
ZX
ZX
ZX
ZX
ZX
"}
(32,1,1) = {"
ZX
ZX
ZX
ZX
ZX
ZX
ZX
ZX
ZX
ZX
ZX
ZX
ZX
ZX
ZX
ZX
ZX
ZX
ZX
ZX
ZX
ZX
ZX
ZX
ZX
ZX
ZX
ZX
ZX
ZX
ZX
ZX
ZX
ZX
ZX
ZX
ZX
ZX
ZX
ZX
"}
(33,1,1) = {"
ZX
ZX
ZX
ZX
ZX
ZX
ZX
ZX
ZX
ZX
ZX
ZX
ZX
ZX
ZX
ZX
ZX
ZX
ZX
ZX
ZX
ZX
ZX
ZX
ZX
ZX
ZX
ZX
ZX
ZX
ZX
ZX
ZX
ZX
ZX
ZX
ZX
ZX
ZX
ZX
"}
(34,1,1) = {"
ZX
ZX
ZX
ZX
ZX
ZX
ZX
ZX
ZX
ZX
ZX
ZX
ZX
ZX
ZX
ZX
ZX
ZX
ZX
ZX
Ai
ZX
ZX
ZX
ZX
ZX
ZX
ZX
ZX
ZX
ZX
ZX
ZX
ZX
ZX
ZX
ZX
ZX
ZX
ZX
"}
(35,1,1) = {"
ZX
ZX
ZX
ZX
ZX
ZX
ZX
ZX
ZX
ZX
ZX
ZX
ZX
ZX
ZX
ZX
ZX
ZX
ZX
ZX
ZX
ZX
ZX
ZX
ZX
ZX
ZX
ZX
ZX
ZX
ZX
ZX
ZX
ZX
ZX
ZX
ZX
ZX
ZX
ZX
"}
(36,1,1) = {"
ZX
ZX
ZX
ZX
ZX
ZX
ZX
ZX
ZX
ZX
ZX
ZX
ZX
ZX
ZX
ZX
ZX
ZX
ZX
ZX
ZX
ZX
ZX
ZX
ZX
ZX
ZX
ZX
ZX
ZX
ZX
ZX
ZX
ZX
ZX
ZX
ZX
ZX
ZX
ZX
"}
(37,1,1) = {"
ZX
ZX
ZX
ZX
ZX
ZX
ZX
ZX
ZX
ZX
ZX
ZX
ZX
ZX
ZX
ZX
ZX
ZX
ZX
ZX
ZX
ZX
ZX
ZX
ZX
ZX
ZX
ZX
ZX
ZX
ZX
ZX
ZX
ZX
ZX
ZX
ZX
ZX
ZX
ZX
"}
(38,1,1) = {"
ZX
ZX
ZX
ZX
ZX
ZX
ZX
ZX
ZX
ZX
ZX
ZX
ZX
ZX
ZX
ZX
ZX
ZX
ZX
ZX
ZX
ZX
ZX
ZX
ZX
ZX
ZX
ZX
ZX
ZX
ZX
ZX
ZX
ZX
ZX
ZX
ZX
ZX
ZX
ZX
"}
(39,1,1) = {"
ZX
ZX
ZX
ZX
ZX
ZX
ZX
ZX
ZX
ZX
ZX
ZX
ZX
ZX
ZX
ZX
ZX
ZX
ZX
ZX
ZX
ZX
ZX
ZX
ZX
ZX
ZX
ZX
ZX
ZX
ZX
ZX
ZX
ZX
ZX
ZX
ZX
ZX
ZX
ZX
"}
(40,1,1) = {"
ZX
ZX
ZX
ZX
ZX
ZX
ZX
ZX
ZX
ZX
ZX
ZX
ZX
ZX
ZX
ZX
ZX
ZX
ZX
ZX
ZX
ZX
ZX
ZX
ZX
ZX
ZX
ZX
ZX
ZX
ZX
ZX
ZX
ZX
ZX
ZX
ZX
ZX
ZX
ZX
"}
(41,1,1) = {"
ZX
ZX
ZX
ZX
ZX
ZX
ZX
ZX
ZX
ZX
ZX
ZX
ZX
ZX
ZX
ZX
ZX
ZX
ZX
ZX
ZX
ZX
ZX
ZX
ZX
ZX
ZX
ZX
ZX
ZX
ZX
ZX
ZX
ZX
ZX
ZX
ZX
ZX
ZX
ZX
"}
(42,1,1) = {"
ZX
ZX
ZX
ZX
ZX
ZX
ZX
ZX
ZX
ZX
ZX
ZX
ZX
ZX
ZX
ZX
ZX
ZX
ZX
ZX
ZX
ZX
ZX
ZX
ZX
ZX
ZX
ZX
ZX
ZX
ZX
ZX
ZX
ZX
ZX
ZX
ZX
ZX
ZX
ZX
"}
(43,1,1) = {"
ZX
ZX
ZX
ZX
ZX
ZX
ZX
ZX
ZX
ZX
ZX
ZX
ZX
ZX
ZX
ZX
ZX
ZX
ZX
ZX
ZX
ZX
ZX
ZX
ZX
ZX
ZX
ZX
ZX
ZX
ZX
ZX
ZX
ZX
ZX
ZX
ZX
ZX
ZX
ZX
"}
(44,1,1) = {"
ZX
ZX
ZX
ZX
ZX
ZX
ZX
ZX
ZX
ZX
ZX
ZX
ZX
ZX
ZX
ZX
ZX
ZX
ZX
ZX
ZX
ZX
ZX
ZX
ZX
ZX
ZX
ZX
ZX
ZX
ZX
ZX
ZX
ZX
ZX
ZX
ZX
ZX
ZX
ZX
"}
(45,1,1) = {"
ZX
ZX
ZX
ZX
ZX
ZX
ZX
ZX
ZX
ZX
ZX
ZX
ZX
ZX
ZX
ZX
ZX
ZX
ZX
ZX
ZX
ZX
ZX
ZX
ZX
ZX
ZX
ZX
ZX
ZX
ZX
ZX
ZX
ZX
ZX
ZX
ZX
ZX
ZX
ZX
"}
(46,1,1) = {"
ZX
ZX
ZX
ZX
ZX
ZX
ZX
ZX
ZX
ZX
ZX
ZX
ZX
ZX
ZX
ZX
ZX
ZX
ZX
ZX
ZX
ZX
ZX
ZX
ZX
ZX
ZX
ZX
ZX
ZX
ZX
ZX
ZX
ZX
ZX
ZX
ZX
ZX
ZX
ZX
"}
(47,1,1) = {"
ZX
ZX
ZX
ZX
ZX
ZX
ZX
ZX
ZX
ZX
ZX
ZX
ZX
ZX
ZX
ZX
ZX
ZX
ZX
ZX
ZX
ZX
ZX
ZX
ZX
ZX
ZX
ZX
ZX
ZX
ZX
ZX
ZX
ZX
ZX
ZX
ZX
ZX
ZX
ZX
"}
