//MAP CONVERTED BY dmm2tgm.py THIS HEADER COMMENT PREVENTS RECONVERSION, DO NOT REMOVE
"al" = (
/obj/structure/machinery/computer/nuke_disk_generator/blue,
/turf/template_noop,
/area/template_noop)
"at" = (
/turf/template_noop,
/area/template_noop)

(1,1,1) = {"
at
at
at
at
at
at
at
at
at
at
at
at
at
at
at
"}
(2,1,1) = {"
at
at
at
at
at
at
at
at
at
at
at
at
at
at
at
"}
(3,1,1) = {"
at
at
at
at
at
at
at
at
at
at
at
at
at
at
at
"}
(4,1,1) = {"
at
at
at
at
at
at
at
at
at
at
at
at
at
at
at
"}
(5,1,1) = {"
at
at
at
at
at
at
at
at
at
at
at
at
at
at
at
"}
(6,1,1) = {"
at
at
at
at
at
at
at
at
at
at
at
at
at
at
at
"}
(7,1,1) = {"
at
at
at
at
at
at
at
at
at
at
at
at
at
at
at
"}
(8,1,1) = {"
at
at
at
at
at
at
at
at
at
at
at
at
at
at
at
"}
(9,1,1) = {"
at
at
at
at
at
at
at
at
at
at
at
at
at
at
at
"}
(10,1,1) = {"
at
at
at
at
at
at
at
at
at
at
at
at
at
at
at
"}
(11,1,1) = {"
at
at
at
at
at
at
at
at
al
at
at
at
at
at
at
"}
(12,1,1) = {"
at
at
at
at
at
at
at
at
at
at
at
at
at
at
at
"}
(13,1,1) = {"
at
at
at
at
at
at
at
at
at
at
at
at
at
at
at
"}
(14,1,1) = {"
at
at
at
at
at
at
at
at
at
at
at
at
at
at
at
"}
(15,1,1) = {"
at
at
at
at
at
at
at
at
at
at
at
at
at
at
at
"}
