//MAP CONVERTED BY dmm2tgm.py THIS HEADER COMMENT PREVENTS RECONVERSION, DO NOT REMOVE
"al" = (
/obj/structure/machinery/computer/nuke_disk_generator/green,
/turf/template_noop,
/area/template_noop)
"aE" = (
/turf/template_noop,
/area/template_noop)

(1,1,1) = {"
aE
aE
aE
aE
aE
"}
(2,1,1) = {"
aE
aE
aE
aE
aE
"}
(3,1,1) = {"
aE
aE
aE
aE
aE
"}
(4,1,1) = {"
aE
aE
aE
al
aE
"}
(5,1,1) = {"
aE
aE
aE
aE
aE
"}
