//MAP CONVERTED BY dmm2tgm.py THIS HEADER COMMENT PREVENTS RECONVERSION, DO NOT REMOVE
"aa" = (
/turf/open/asphalt{
	icon_state = "tile"
	},
/area/desert_dam/exterior/valley/valley_medical)
"ab" = (
/obj/effect/blocker/toxic_water/Group_2,
/turf/open/desert/desert_shore/shore_corner2{
	icon_state = "shore_corner2";
	dir = 8
	},
/area/desert_dam/exterior/river/riverside_east)
"ac" = (
/obj/effect/blocker/toxic_water/Group_2,
/obj/structure/platform{
	dir = 8
	},
/turf/open/gm/river/desert/shallow_edge{
	icon_state = "shallow_edge";
	dir = 1
	},
/area/desert_dam/exterior/river/riverside_east)
"ad" = (
/turf/open/asphalt/cement_sunbleached{
	icon_state = "cement_sunbleached1"
	},
/area/desert_dam/exterior/valley/valley_bridge)
"ah" = (
/obj/effect/blocker/toxic_water/Group_2,
/turf/open/gm/river/desert/shallow_edge/covered{
	dir = 4
	},
/area/desert_dam/exterior/river/riverside_east)
"ai" = (
/obj/effect/decal/sand_overlay/sand1/corner1,
/turf/open/asphalt{
	icon_state = "tile"
	},
/area/desert_dam/exterior/valley/valley_medical)
"aj" = (
/obj/effect/blocker/toxic_water/Group_2,
/obj/structure/platform{
	dir = 8
	},
/turf/open/gm/river/desert/deep,
/area/desert_dam/exterior/river/riverside_east)
"ak" = (
/obj/effect/blocker/toxic_water/Group_2,
/turf/open/desert/desert_shore/desert_shore1{
	icon_state = "shore1";
	dir = 1
	},
/area/desert_dam/exterior/river/riverside_east)
"al" = (
/turf/open/asphalt/cement_sunbleached{
	icon_state = "cement_sunbleached15"
	},
/area/desert_dam/exterior/valley/valley_bridge)
"an" = (
/obj/effect/decal/sand_overlay/sand1/corner1{
	dir = 1;
	icon = 'icons/turf/overlays.dmi';
	icon_state = "sand1_c"
	},
/turf/open/asphalt{
	icon_state = "tile"
	},
/area/desert_dam/exterior/valley/valley_bridge)
"ao" = (
/obj/effect/decal/sand_overlay/sand1{
	dir = 1;
	icon = 'icons/turf/overlays.dmi';
	icon_state = "sand1_s"
	},
/turf/open/asphalt{
	icon_state = "tile"
	},
/area/desert_dam/exterior/valley/valley_bridge)
"aq" = (
/turf/open/asphalt/cement_sunbleached,
/area/desert_dam/exterior/valley/valley_medical)
"ar" = (
/obj/effect/decal/sand_overlay/sand1{
	dir = 8;
	icon = 'icons/turf/overlays.dmi';
	icon_state = "sand1_s"
	},
/turf/open/asphalt/cement_sunbleached{
	icon_state = "cement_sunbleached1"
	},
/area/desert_dam/exterior/valley/valley_medical)
"as" = (
/obj/effect/blocker/toxic_water/Group_2,
/turf/open/gm/river/desert/shallow_corner,
/area/desert_dam/exterior/river/riverside_east)
"at" = (
/obj/structure/platform{
	dir = 1
	},
/obj/effect/blocker/toxic_water/Group_2,
/obj/structure/platform{
	dir = 8
	},
/turf/open/gm/river/desert/shallow,
/area/desert_dam/exterior/river/riverside_east)
"au" = (
/turf/open/asphalt/cement_sunbleached{
	icon_state = "cement_sunbleached3"
	},
/area/desert_dam/exterior/valley/valley_medical)
"av" = (
/turf/open/desert/dirt,
/area/desert_dam/exterior/valley/valley_bridge)
"aw" = (
/obj/effect/blocker/toxic_water/Group_2,
/turf/open/gm/river/desert/shallow_edge/covered,
/area/desert_dam/exterior/river/riverside_east)
"ax" = (
/obj/structure/platform,
/obj/effect/blocker/toxic_water/Group_2,
/turf/open/gm/river/desert/shallow_edge,
/area/desert_dam/exterior/river/riverside_east)
"ay" = (
/obj/effect/decal/sand_overlay/sand1/corner1{
	dir = 4;
	icon = 'icons/turf/overlays.dmi';
	icon_state = "sand1_c"
	},
/turf/open/asphalt{
	icon_state = "tile"
	},
/area/desert_dam/exterior/valley/valley_bridge)
"az" = (
/obj/structure/platform_decoration,
/obj/effect/blocker/toxic_water/Group_2,
/turf/open/gm/river/desert/shallow_edge,
/area/desert_dam/exterior/river/riverside_east)
"aA" = (
/obj/effect/blocker/toxic_water/Group_2,
/turf/open/gm/river/desert/shallow_corner{
	icon_state = "shallow_c";
	dir = 8
	},
/area/desert_dam/exterior/river/riverside_east)
"aB" = (
/turf/open/desert/dirt{
	icon_state = "dirt2"
	},
/area/desert_dam/exterior/river/riverside_east)
"aC" = (
/obj/effect/blocker/toxic_water/Group_2,
/turf/open/gm/river/desert/shallow_edge{
	icon_state = "shallow_edge";
	dir = 5
	},
/area/desert_dam/exterior/river/riverside_east)
"aF" = (
/obj/structure/platform_decoration{
	icon_state = "platform_deco";
	dir = 4
	},
/obj/effect/blocker/toxic_water/Group_2,
/turf/open/gm/river/desert/shallow_edge{
	icon_state = "shallow_edge";
	dir = 8
	},
/area/desert_dam/exterior/river/riverside_east)
"aG" = (
/obj/effect/decal/sand_overlay/sand1{
	dir = 8;
	icon = 'icons/turf/overlays.dmi';
	icon_state = "sand1_s"
	},
/turf/open/asphalt{
	icon_state = "tile"
	},
/area/desert_dam/exterior/valley/valley_bridge)
"aI" = (
/obj/structure/platform{
	dir = 1
	},
/obj/structure/platform{
	dir = 8
	},
/obj/effect/blocker/toxic_water/Group_2,
/turf/open/desert/desert_shore/shore_corner2{
	icon_state = "shore_corner2";
	dir = 1
	},
/area/desert_dam/exterior/river/riverside_east)
"aJ" = (
/turf/closed/wall/rock/orange,
/area/desert_dam/exterior/rock)
"aK" = (
/turf/open/asphalt{
	icon_state = "tile"
	},
/area/desert_dam/exterior/valley/valley_bridge)
"aL" = (
/obj/structure/stairs{
	dir = 8
	},
/obj/structure/platform,
/turf/open/asphalt/cement_sunbleached{
	icon_state = "cement_sunbleached14"
	},
/area/desert_dam/exterior/valley/valley_medical)
"aM" = (
/obj/structure/platform{
	dir = 1
	},
/obj/effect/blocker/toxic_water/Group_2,
/turf/open/desert/desert_shore/shore_corner2{
	icon_state = "shore_corner2";
	dir = 1
	},
/area/desert_dam/exterior/river/riverside_east)
"aN" = (
/obj/structure/platform_decoration{
	icon_state = "platform_deco";
	dir = 4
	},
/obj/effect/blocker/toxic_water/Group_2,
/turf/open/gm/river/desert/shallow_edge{
	icon_state = "shallow_edge";
	dir = 9
	},
/area/desert_dam/exterior/river/riverside_east)
"aO" = (
/obj/effect/decal/sand_overlay/sand1{
	dir = 8;
	icon = 'icons/turf/overlays.dmi';
	icon_state = "sand1_s"
	},
/turf/open/asphalt/cement_sunbleached{
	icon_state = "cement_sunbleached9"
	},
/area/desert_dam/exterior/valley/valley_medical)
"aP" = (
/obj/effect/blocker/toxic_water/Group_2,
/turf/open/gm/river/desert/deep,
/area/desert_dam/exterior/river/riverside_east)
"aQ" = (
/obj/structure/platform{
	dir = 4
	},
/obj/effect/blocker/toxic_water/Group_2,
/turf/open/gm/river/desert/deep,
/area/desert_dam/exterior/river/riverside_east)
"aR" = (
/obj/effect/blocker/toxic_water/Group_2,
/turf/open/gm/river/desert/shallow_edge{
	icon_state = "shallow_edge";
	dir = 1
	},
/area/desert_dam/exterior/river/riverside_east)
"aS" = (
/obj/effect/blocker/toxic_water/Group_2,
/turf/open/gm/river/desert/shallow_corner{
	icon_state = "shallow_c";
	dir = 1
	},
/area/desert_dam/exterior/river/riverside_east)
"aT" = (
/obj/structure/platform{
	dir = 4
	},
/obj/effect/blocker/toxic_water/Group_2,
/turf/open/gm/river/desert/shallow_corner,
/area/desert_dam/exterior/river/riverside_east)
"aU" = (
/obj/structure/platform{
	dir = 1
	},
/obj/effect/blocker/toxic_water/Group_2,
/turf/open/desert/desert_shore/shore_corner2{
	icon_state = "shore_corner2";
	dir = 8
	},
/area/desert_dam/exterior/river/riverside_east)
"aV" = (
/obj/structure/platform_decoration{
	dir = 8;
	icon_state = "platform_deco"
	},
/obj/effect/blocker/toxic_water/Group_2,
/turf/open/gm/river/desert/deep,
/area/desert_dam/exterior/river/riverside_east)
"aW" = (
/turf/open/asphalt/cement_sunbleached{
	icon_state = "cement_sunbleached4"
	},
/area/desert_dam/exterior/valley/valley_medical)
"aX" = (
/obj/structure/platform{
	dir = 1
	},
/obj/effect/blocker/toxic_water/Group_2,
/turf/open/desert/desert_shore/shore_edge1{
	icon_state = "shore_edge1";
	dir = 4
	},
/area/desert_dam/exterior/river/riverside_east)
"aY" = (
/turf/open/asphalt/cement_sunbleached{
	icon_state = "cement_sunbleached1"
	},
/area/desert_dam/exterior/valley/valley_medical)
"aZ" = (
/obj/effect/blocker/toxic_water/Group_2,
/turf/open/gm/river/desert/shallow_corner/covered,
/area/desert_dam/exterior/river/riverside_east)
"ba" = (
/turf/open/asphalt/cement_sunbleached{
	icon_state = "cement_sunbleached3"
	},
/area/desert_dam/exterior/valley/valley_bridge)
"bc" = (
/obj/effect/blocker/toxic_water/Group_2,
/obj/structure/platform,
/obj/structure/platform{
	dir = 8
	},
/turf/open/gm/river/desert/shallow_edge,
/area/desert_dam/exterior/river/riverside_east)
"bd" = (
/obj/effect/blocker/toxic_water/Group_2,
/turf/open/gm/river/desert/deep/covered,
/area/desert_dam/exterior/river/riverside_east)
"bf" = (
/obj/effect/blocker/toxic_water/Group_2,
/obj/structure/platform{
	dir = 4
	},
/turf/open/gm/river/desert/deep,
/area/desert_dam/exterior/river/riverside_east)
"bg" = (
/obj/effect/blocker/toxic_water/Group_2,
/turf/open/gm/river/desert/shallow_edge{
	icon_state = "shallow_edge";
	dir = 10
	},
/area/desert_dam/exterior/river/riverside_east)
"bh" = (
/obj/effect/blocker/toxic_water/Group_2,
/turf/open/desert/desert_shore/shore_corner2,
/area/desert_dam/exterior/river/riverside_east)
"bi" = (
/obj/effect/blocker/toxic_water/Group_2,
/obj/effect/blocker/toxic_water/Group_2,
/turf/open/gm/river/desert/shallow,
/area/desert_dam/exterior/river/riverside_east)
"bj" = (
/obj/effect/blocker/toxic_water/Group_2,
/turf/open/gm/river/desert/shallow_edge,
/area/desert_dam/exterior/river/riverside_east)
"bk" = (
/obj/effect/blocker/toxic_water/Group_2,
/turf/open/desert/desert_shore/shore_edge1,
/area/desert_dam/exterior/river/riverside_east)
"bl" = (
/obj/structure/platform,
/turf/open/desert/dirt{
	icon_state = "dirt2"
	},
/area/desert_dam/exterior/river/riverside_east)
"bm" = (
/obj/effect/blocker/toxic_water/Group_2,
/turf/open/desert/desert_shore/desert_shore1,
/area/desert_dam/exterior/river/riverside_east)
"bn" = (
/obj/structure/stairs{
	dir = 8
	},
/obj/structure/platform{
	dir = 1
	},
/turf/open/asphalt/cement_sunbleached{
	icon_state = "cement_sunbleached2"
	},
/area/desert_dam/exterior/valley/valley_medical)
"bo" = (
/obj/structure/platform{
	dir = 4
	},
/obj/effect/blocker/toxic_water/Group_2,
/turf/open/desert/desert_shore/desert_shore1,
/area/desert_dam/exterior/river/riverside_east)
"bp" = (
/obj/structure/platform,
/obj/effect/blocker/toxic_water/Group_2,
/obj/effect/blocker/toxic_water/Group_2,
/turf/open/gm/river/desert/shallow_edge,
/area/desert_dam/exterior/river/riverside_east)
"br" = (
/obj/structure/platform,
/turf/open/asphalt/cement_sunbleached,
/area/desert_dam/exterior/valley/valley_medical)
"bs" = (
/obj/structure/platform,
/obj/effect/blocker/toxic_water/Group_2,
/obj/structure/platform{
	dir = 4
	},
/turf/open/gm/river/desert/shallow_edge,
/area/desert_dam/exterior/river/riverside_east)
"bt" = (
/turf/open/asphalt/cement_sunbleached{
	icon_state = "cement_sunbleached14"
	},
/area/desert_dam/exterior/valley/valley_bridge)
"bu" = (
/obj/structure/platform_decoration{
	icon_state = "platform_deco";
	dir = 1
	},
/turf/open/desert/dirt{
	icon_state = "dirt2"
	},
/area/desert_dam/exterior/river/riverside_east)
"bv" = (
/obj/structure/platform{
	dir = 1
	},
/obj/effect/blocker/toxic_water/Group_2,
/obj/structure/platform{
	dir = 4
	},
/turf/open/gm/river/desert/deep,
/area/desert_dam/exterior/river/riverside_east)
"bw" = (
/obj/structure/platform{
	dir = 1
	},
/obj/effect/blocker/toxic_water/Group_2,
/turf/open/desert/dirt{
	icon_state = "dirt2"
	},
/area/desert_dam/exterior/river/riverside_east)
"bx" = (
/obj/structure/platform_decoration{
	dir = 8;
	icon_state = "platform_deco"
	},
/turf/open/desert/dirt{
	icon_state = "dirt2"
	},
/area/desert_dam/exterior/river/riverside_east)
"by" = (
/obj/structure/stairs{
	dir = 1
	},
/obj/structure/platform{
	dir = 8
	},
/turf/open/asphalt/cement_sunbleached{
	icon_state = "cement_sunbleached3"
	},
/area/desert_dam/exterior/valley/valley_medical)
"bz" = (
/obj/structure/stairs{
	dir = 1
	},
/obj/structure/platform{
	dir = 4
	},
/turf/open/asphalt/cement_sunbleached{
	icon_state = "cement_sunbleached1"
	},
/area/desert_dam/exterior/valley/valley_medical)
"bB" = (
/obj/structure/platform_decoration,
/turf/open/desert/dirt{
	icon_state = "dirt2"
	},
/area/desert_dam/exterior/river/riverside_east)

(1,1,1) = {"
aK
aM
aR
aP
aP
aP
aA
bg
bh
bk
aB
bl
aa
"}
(2,1,1) = {"
aI
aN
aS
aP
aP
aP
aP
bj
bi
bm
aB
bl
aa
"}
(3,1,1) = {"
aF
aS
aP
aP
aP
aP
aP
aA
bg
bm
aB
bl
aa
"}
(4,1,1) = {"
aP
aP
aP
aP
aP
aP
aP
aP
bj
bm
aB
bl
aa
"}
(5,1,1) = {"
aP
aP
aP
aP
aP
aP
aP
aP
bj
bm
aB
bu
by
"}
(6,1,1) = {"
aT
aQ
aV
aP
aP
aP
aP
aP
az
bo
bx
bB
bz
"}
(7,1,1) = {"
aK
aK
bv
bf
bf
bf
bf
bf
bs
aa
bn
aL
aa
"}
(8,1,1) = {"
ba
bt
bd
bd
bd
bd
bd
bd
aw
au
aq
br
aa
"}
(9,1,1) = {"
ad
al
ah
aZ
bd
bd
bd
bd
aw
aY
aq
br
aa
"}
(10,1,1) = {"
aG
ay
at
ac
aj
aj
aj
aj
bc
aa
aW
br
aa
"}
(11,1,1) = {"
av
ao
aU
aC
as
aP
aP
aP
ax
aa
aW
aq
au
"}
(12,1,1) = {"
aJ
an
aX
ab
aR
aP
aP
aP
bp
aa
aW
aq
aq
"}
(13,1,1) = {"
aJ
aK
bw
ak
aR
aP
aP
aP
ax
aa
aW
aq
aq
"}
(14,1,1) = {"
aJ
aK
bw
ak
aR
aP
aP
aP
ax
ai
aO
ar
ar
"}
