//MAP CONVERTED BY dmm2tgm.py THIS HEADER COMMENT PREVENTS RECONVERSION, DO NOT REMOVE
"a" = (
/obj/effect/mapping_helpers/sunlight/pseudo_roof_setter/ship_hull,
/turf/closed/shuttle/ert{
	icon_state = "upp4"
	},
/area/shuttle/ert)
"c" = (
/obj/effect/mapping_helpers/sunlight/pseudo_roof_setter/ship_hull,
/turf/open/shuttle/dropship{
	icon_state = "rasputin7"
	},
/area/shuttle/ert)
"e" = (
/obj/docking_port/mobile/emergency_response/ert3,
/obj/effect/mapping_helpers/sunlight/pseudo_roof_setter/ship_hull,
/turf/closed/shuttle/ert{
	icon_state = "leftengine_1";
	opacity = 0
	},
/area/shuttle/ert)
"g" = (
/obj/effect/mapping_helpers/sunlight/pseudo_roof_setter/ship_hull,
/turf/closed/shuttle/ert{
	icon_state = "upp5"
	},
/area/shuttle/ert)
"h" = (
/obj/structure/bed/chair/dropship/passenger{
	dir = 8
	},
/obj/effect/landmark/ert_spawns/distress_upp,
/obj/effect/mapping_helpers/sunlight/pseudo_roof_setter/ship_hull,
/turf/open/shuttle/dropship{
	icon_state = "rasputin15"
	},
/area/shuttle/ert)
"i" = (
/obj/effect/mapping_helpers/sunlight/pseudo_roof_setter/ship_hull,
/turf/open/shuttle/dropship{
	icon_state = "rasputin4"
	},
/area/shuttle/ert)
"j" = (
/obj/effect/mapping_helpers/sunlight/pseudo_roof_setter/ship_hull,
/turf/closed/shuttle/ert{
	icon_state = "upp_leftengine"
	},
/area/shuttle/ert)
"k" = (
/obj/effect/mapping_helpers/sunlight/pseudo_roof_setter/ship_hull,
/turf/open/shuttle/dropship{
	icon_state = "floor8"
	},
/area/shuttle/ert)
"l" = (
/obj/effect/mapping_helpers/sunlight/pseudo_roof_setter/ship_hull,
/turf/closed/shuttle/ert{
	icon_state = "leftengine_2";
	opacity = 0
	},
/area/shuttle/ert)
"m" = (
/obj/effect/mapping_helpers/sunlight/pseudo_roof_setter/ship_hull,
/turf/closed/shuttle/ert{
	icon_state = "upp23"
	},
/area/shuttle/ert)
"n" = (
/obj/structure/surface/rack,
/obj/item/storage/firstaid/regular,
/obj/effect/landmark/ert_spawns/distress_upp/item,
/obj/item/storage/belt/medical/lifesaver/upp/full,
/obj/item/device/healthanalyzer,
/obj/effect/mapping_helpers/sunlight/pseudo_roof_setter/ship_hull,
/turf/open/shuttle/dropship{
	icon_state = "rasputin15"
	},
/area/shuttle/ert)
"p" = (
/obj/effect/mapping_helpers/sunlight/pseudo_roof_setter/ship_hull,
/turf/closed/shuttle/ert{
	icon_state = "upp_rightengine"
	},
/area/shuttle/ert)
"q" = (
/obj/effect/mapping_helpers/sunlight/pseudo_roof_setter/ship_hull,
/turf/closed/shuttle/ert{
	icon_state = "upp22"
	},
/area/shuttle/ert)
"r" = (
/obj/effect/mapping_helpers/sunlight/pseudo_roof_setter/ship_hull,
/turf/closed/shuttle/ert{
	icon_state = "rightengine_3";
	opacity = 0
	},
/area/shuttle/ert)
"s" = (
/obj/effect/mapping_helpers/sunlight/pseudo_roof_setter/ship_hull,
/turf/open/shuttle/dropship{
	icon_state = "rasputin6"
	},
/area/shuttle/ert)
"t" = (
/obj/effect/mapping_helpers/sunlight/pseudo_roof_setter/ship_hull,
/obj/structure/machinery/light{
	pixel_x = 0;
	req_light_switch = 0
	},
/turf/open/shuttle/dropship{
	icon_state = "rasputin3"
	},
/area/shuttle/ert)
"u" = (
/obj/effect/mapping_helpers/sunlight/pseudo_roof_setter/ship_hull,
/turf/closed/shuttle/ert{
	icon_state = "upp8"
	},
/area/shuttle/ert)
"v" = (
/obj/effect/mapping_helpers/sunlight/pseudo_roof_setter/ship_hull,
/turf/closed/shuttle/ert{
	icon_state = "upp21"
	},
/area/shuttle/ert)
"w" = (
/obj/effect/mapping_helpers/sunlight/pseudo_roof_setter/ship_hull,
/turf/closed/shuttle/ert{
	icon_state = "upp2"
	},
/area/shuttle/ert)
"x" = (
/obj/effect/mapping_helpers/sunlight/pseudo_roof_setter/ship_hull,
/turf/closed/shuttle/ert{
	icon_state = "upp3"
	},
/area/shuttle/ert)
"y" = (
/obj/effect/mapping_helpers/sunlight/pseudo_roof_setter/ship_hull,
/turf/closed/shuttle/ert{
	icon_state = "upp9"
	},
/area/shuttle/ert)
"z" = (
/obj/effect/mapping_helpers/sunlight/pseudo_roof_setter/ship_hull,
/turf/closed/shuttle/ert{
	icon_state = "upp20"
	},
/area/shuttle/ert)
"A" = (
/obj/effect/mapping_helpers/sunlight/pseudo_roof_setter/ship_hull,
/turf/closed/shuttle/ert{
	icon_state = "upp1"
	},
/area/shuttle/ert)
"B" = (
/obj/structure/bed/chair/dropship/passenger{
	dir = 4
	},
/obj/effect/landmark/ert_spawns/distress_upp,
/obj/effect/mapping_helpers/sunlight/pseudo_roof_setter/ship_hull,
/turf/open/shuttle/dropship{
	icon_state = "rasputin15"
	},
/area/shuttle/ert)
"C" = (
/obj/structure/surface/rack,
/obj/effect/landmark/ert_spawns/distress_upp/item,
/obj/item/storage/toolbox/syndicate,
/obj/effect/mapping_helpers/sunlight/pseudo_roof_setter/ship_hull,
/turf/open/shuttle/dropship{
	icon_state = "rasputin15"
	},
/area/shuttle/ert)
"E" = (
/obj/effect/mapping_helpers/sunlight/pseudo_roof_setter/ship_hull,
/turf/closed/shuttle/ert{
	icon_state = "upp25"
	},
/area/shuttle/ert)
"F" = (
/obj/effect/mapping_helpers/sunlight/pseudo_roof_setter/ship_hull,
/turf/closed/shuttle/ert{
	icon_state = "rightengine_1";
	opacity = 0
	},
/area/shuttle/ert)
"G" = (
/obj/structure/machinery/door/airlock/almayer/generic,
/obj/effect/mapping_helpers/sunlight/pseudo_roof_setter/ship_hull,
/turf/open/shuttle/dropship{
	icon_state = "rasputin3"
	},
/area/shuttle/ert)
"I" = (
/obj/effect/mapping_helpers/sunlight/pseudo_roof_setter/ship_hull,
/turf/closed/shuttle/ert{
	icon_state = "upp27"
	},
/area/shuttle/ert)
"J" = (
/obj/structure/surface/rack,
/obj/item/storage/firstaid/adv{
	pixel_x = 2;
	pixel_y = -5
	},
/obj/effect/landmark/ert_spawns/distress_upp/item,
/obj/effect/mapping_helpers/sunlight/pseudo_roof_setter/ship_hull,
/turf/open/shuttle/dropship{
	icon_state = "rasputin15"
	},
/area/shuttle/ert)
"K" = (
/turf/template_noop,
/area/template_noop)
"L" = (
/obj/structure/bed/chair/dropship/passenger{
	dir = 8
	},
/obj/effect/landmark/ert_spawns/distress_upp,
/obj/effect/mapping_helpers/sunlight/pseudo_roof_setter/ship_hull,
/obj/structure/machinery/light{
	dir = 4;
	req_light_switch = 0
	},
/turf/open/shuttle/dropship{
	icon_state = "rasputin15"
	},
/area/shuttle/ert)
"N" = (
/obj/effect/mapping_helpers/sunlight/pseudo_roof_setter/ship_hull,
/turf/open/shuttle/dropship{
	icon_state = "rasputin8"
	},
/area/shuttle/ert)
"O" = (
/obj/effect/mapping_helpers/sunlight/pseudo_roof_setter/ship_hull,
/turf/open/shuttle/dropship{
	icon_state = "rasputin3"
	},
/area/shuttle/ert)
"P" = (
/obj/effect/mapping_helpers/sunlight/pseudo_roof_setter/ship_hull,
/turf/closed/shuttle/ert{
	icon_state = "leftengine_3";
	opacity = 0
	},
/area/shuttle/ert)
"Q" = (
/obj/effect/mapping_helpers/sunlight/pseudo_roof_setter/ship_hull,
/turf/closed/shuttle/ert{
	icon_state = "upp16"
	},
/area/shuttle/ert)
"R" = (
/obj/effect/landmark/ert_spawns/distress_upp,
/obj/effect/mapping_helpers/sunlight/pseudo_roof_setter/ship_hull,
/turf/open/shuttle/dropship{
	icon_state = "rasputin3"
	},
/area/shuttle/ert)
"S" = (
/obj/structure/bed/chair/dropship/passenger,
/obj/effect/landmark/ert_spawns/distress_upp,
/obj/effect/mapping_helpers/sunlight/pseudo_roof_setter/ship_hull,
/turf/open/shuttle/dropship{
	icon_state = "rasputin15"
	},
/area/shuttle/ert)
"T" = (
/obj/effect/mapping_helpers/sunlight/pseudo_roof_setter/ship_hull,
/turf/open/shuttle/dropship{
	icon_state = "rasputin15"
	},
/area/shuttle/ert)
"U" = (
/obj/structure/bed/chair/dropship/passenger{
	dir = 4
	},
/obj/effect/landmark/ert_spawns/distress_upp,
/obj/effect/mapping_helpers/sunlight/pseudo_roof_setter/ship_hull,
/obj/structure/machinery/light{
	dir = 8;
	req_light_switch = 0
	},
/turf/open/shuttle/dropship{
	icon_state = "rasputin15"
	},
/area/shuttle/ert)
"V" = (
/obj/effect/mapping_helpers/sunlight/pseudo_roof_setter/ship_hull,
/turf/closed/shuttle/ert{
	icon_state = "rightengine_2";
	opacity = 0
	},
/area/shuttle/ert)
"X" = (
/obj/structure/blocker/invisible_wall,
/obj/structure/machinery/computer/shuttle/ert,
/obj/effect/mapping_helpers/sunlight/pseudo_roof_setter/ship_hull,
/turf/open/shuttle/dropship{
	icon_state = "rasputin15"
	},
/area/shuttle/ert)
"Y" = (
/obj/structure/machinery/door/airlock/almayer/generic{
	dir = 2
	},
/obj/effect/mapping_helpers/sunlight/pseudo_roof_setter/ship_hull,
/turf/open/shuttle/dropship{
	icon_state = "rasputin15"
	},
/area/shuttle/ert)
"Z" = (
/obj/structure/surface/rack,
/obj/effect/landmark/ert_spawns/distress_upp/item,
/obj/item/storage/firstaid/regular,
/obj/item/storage/belt/medical/lifesaver/upp/full,
/obj/item/device/healthanalyzer,
/obj/effect/mapping_helpers/sunlight/pseudo_roof_setter/ship_hull,
/turf/open/shuttle/dropship{
	icon_state = "rasputin15"
	},
/area/shuttle/ert)

(1,1,1) = {"
K
z
a
G
Q
a
a
G
a
j
P
l
e
"}
(2,1,1) = {"
K
v
C
T
B
U
B
T
Z
u
a
a
A
"}
(3,1,1) = {"
z
q
s
R
R
R
R
R
i
T
T
T
Y
"}
(4,1,1) = {"
I
X
k
S
S
S
S
S
k
O
O
t
w
"}
(5,1,1) = {"
E
m
c
R
R
R
R
R
N
T
T
T
Y
"}
(6,1,1) = {"
K
v
J
T
h
L
h
T
n
y
g
g
x
"}
(7,1,1) = {"
K
E
g
G
g
g
g
G
g
p
r
V
F
"}
