//MAP CONVERTED BY dmm2tgm.py THIS HEADER COMMENT PREVENTS RECONVERSION, DO NOT REMOVE
"a" = (
/obj/effect/mapping_helpers/sunlight/pseudo_roof_setter/ship_hull,
/turf/closed/shuttle/ert{
	icon_state = "rightengine_1";
	opacity = 0
	},
/area/shuttle/ert)
"b" = (
/obj/effect/mapping_helpers/sunlight/pseudo_roof_setter/ship_hull,
/turf/closed/shuttle/ert{
	icon_state = "wy_leftengine"
	},
/area/shuttle/ert)
"c" = (
/obj/effect/mapping_helpers/sunlight/pseudo_roof_setter/ship_hull,
/turf/closed/shuttle/ert{
	icon_state = "wy21"
	},
/area/shuttle/ert)
"d" = (
/obj/effect/mapping_helpers/sunlight/pseudo_roof_setter/ship_hull,
/turf/open/shuttle/dropship{
	icon_state = "rasputin6"
	},
/area/shuttle/ert)
"e" = (
/obj/effect/mapping_helpers/sunlight/pseudo_roof_setter/ship_hull,
/turf/closed/shuttle/ert{
	icon_state = "wy13"
	},
/area/shuttle/ert)
"f" = (
/obj/structure/surface/rack,
/obj/effect/landmark/ert_spawns/distress_pmc/item,
/obj/item/storage/firstaid/regular,
/obj/item/storage/belt/medical/lifesaver/full,
/obj/item/device/healthanalyzer,
/obj/effect/mapping_helpers/sunlight/pseudo_roof_setter/ship_hull,
/turf/open/shuttle/dropship{
	icon_state = "rasputin15"
	},
/area/shuttle/ert)
"g" = (
/obj/structure/surface/rack,
/obj/effect/landmark/ert_spawns/distress_pmc/item,
/obj/item/storage/firstaid/adv{
	pixel_x = 2;
	pixel_y = -5
	},
/obj/effect/mapping_helpers/sunlight/pseudo_roof_setter/ship_hull,
/turf/open/shuttle/dropship{
	icon_state = "rasputin15"
	},
/area/shuttle/ert)
"h" = (
/obj/effect/mapping_helpers/sunlight/pseudo_roof_setter/ship_hull,
/turf/open/shuttle/dropship{
	icon_state = "rasputin8"
	},
/area/shuttle/ert)
"i" = (
/turf/template_noop,
/area/template_noop)
"j" = (
/obj/effect/mapping_helpers/sunlight/pseudo_roof_setter/ship_hull,
/turf/closed/shuttle/ert{
	icon_state = "wy12"
	},
/area/shuttle/ert)
"k" = (
/obj/effect/mapping_helpers/sunlight/pseudo_roof_setter/ship_hull,
/turf/open/shuttle/dropship{
	icon_state = "rasputin15"
	},
/area/shuttle/ert)
"l" = (
/obj/effect/mapping_helpers/sunlight/pseudo_roof_setter/ship_hull,
/turf/closed/shuttle/ert{
	icon_state = "wy23"
	},
/area/shuttle/ert)
"m" = (
/obj/effect/mapping_helpers/sunlight/pseudo_roof_setter/ship_hull,
/turf/open/shuttle/dropship{
	icon_state = "rasputin7"
	},
/area/shuttle/ert)
"n" = (
/obj/effect/mapping_helpers/sunlight/pseudo_roof_setter/ship_hull,
/turf/closed/shuttle/ert{
	icon_state = "wy17"
	},
/area/shuttle/ert)
"o" = (
/obj/docking_port/mobile/emergency_response/ert2,
/obj/effect/mapping_helpers/sunlight/pseudo_roof_setter/ship_hull,
/turf/closed/shuttle/ert{
	icon_state = "leftengine_1";
	opacity = 0
	},
/area/shuttle/ert)
"p" = (
/obj/effect/mapping_helpers/sunlight/pseudo_roof_setter/ship_hull,
/turf/closed/shuttle/ert{
	icon_state = "wy4"
	},
/area/shuttle/ert)
"q" = (
/obj/structure/machinery/door/airlock/almayer/generic{
	dir = 2
	},
/obj/effect/mapping_helpers/sunlight/pseudo_roof_setter/ship_hull,
/turf/open/shuttle/dropship{
	icon_state = "rasputin15"
	},
/area/shuttle/ert)
"r" = (
/obj/effect/mapping_helpers/sunlight/pseudo_roof_setter/ship_hull,
/turf/closed/shuttle/ert{
	icon_state = "wy5"
	},
/area/shuttle/ert)
"s" = (
/obj/effect/mapping_helpers/sunlight/pseudo_roof_setter/ship_hull,
/turf/open/shuttle/dropship{
	icon_state = "rasputin3"
	},
/area/shuttle/ert)
"t" = (
/obj/structure/machinery/door/airlock/almayer/generic,
/obj/effect/mapping_helpers/sunlight/pseudo_roof_setter/ship_hull,
/turf/open/shuttle/dropship{
	icon_state = "rasputin3"
	},
/area/shuttle/ert)
"u" = (
/obj/structure/bed/chair/dropship/passenger{
	dir = 4
	},
/obj/effect/landmark/ert_spawns/distress_pmc,
/obj/effect/mapping_helpers/sunlight/pseudo_roof_setter/ship_hull,
/turf/open/shuttle/dropship{
	icon_state = "rasputin15"
	},
/area/shuttle/ert)
"v" = (
/obj/effect/mapping_helpers/sunlight/pseudo_roof_setter/ship_hull,
/turf/closed/shuttle/ert{
	icon_state = "wy8"
	},
/area/shuttle/ert)
"w" = (
/obj/effect/mapping_helpers/sunlight/pseudo_roof_setter/ship_hull,
/turf/closed/shuttle/ert{
	icon_state = "wy_rightengine"
	},
/area/shuttle/ert)
"x" = (
/obj/effect/mapping_helpers/sunlight/pseudo_roof_setter/ship_hull,
/turf/closed/shuttle/ert{
	icon_state = "wy16"
	},
/area/shuttle/ert)
"y" = (
/obj/effect/mapping_helpers/sunlight/pseudo_roof_setter/ship_hull,
/turf/closed/shuttle/ert{
	icon_state = "wy25"
	},
/area/shuttle/ert)
"z" = (
/obj/effect/mapping_helpers/sunlight/pseudo_roof_setter/ship_hull,
/turf/closed/shuttle/ert{
	icon_state = "leftengine_3";
	opacity = 0
	},
/area/shuttle/ert)
"A" = (
/obj/effect/mapping_helpers/sunlight/pseudo_roof_setter/ship_hull,
/turf/closed/shuttle/ert{
	icon_state = "wy27"
	},
/area/shuttle/ert)
"C" = (
/obj/structure/bed/chair/dropship/passenger{
	dir = 4
	},
/obj/effect/landmark/ert_spawns/distress_pmc,
/obj/effect/mapping_helpers/sunlight/pseudo_roof_setter/ship_hull,
/obj/structure/machinery/light{
	dir = 8;
	req_light_switch = 0
	},
/turf/open/shuttle/dropship{
	icon_state = "rasputin15"
	},
/area/shuttle/ert)
"D" = (
/obj/effect/mapping_helpers/sunlight/pseudo_roof_setter/ship_hull,
/turf/closed/shuttle/ert{
	icon_state = "wy15"
	},
/area/shuttle/ert)
"E" = (
/obj/effect/mapping_helpers/sunlight/pseudo_roof_setter/ship_hull,
/turf/closed/shuttle/ert{
	icon_state = "wy22"
	},
/area/shuttle/ert)
"F" = (
/obj/effect/mapping_helpers/sunlight/pseudo_roof_setter/ship_hull,
/turf/closed/shuttle/ert{
	icon_state = "wy19"
	},
/area/shuttle/ert)
"G" = (
/obj/effect/mapping_helpers/sunlight/pseudo_roof_setter/ship_hull,
/turf/open/shuttle/dropship{
	icon_state = "floor8"
	},
/area/shuttle/ert)
"H" = (
/obj/structure/bed/chair/dropship/passenger,
/obj/effect/landmark/ert_spawns/distress_pmc,
/obj/effect/mapping_helpers/sunlight/pseudo_roof_setter/ship_hull,
/turf/open/shuttle/dropship{
	icon_state = "rasputin15"
	},
/area/shuttle/ert)
"I" = (
/obj/structure/blocker/invisible_wall,
/obj/structure/machinery/computer/shuttle/ert,
/obj/effect/mapping_helpers/sunlight/pseudo_roof_setter/ship_hull,
/turf/open/shuttle/dropship{
	icon_state = "rasputin15"
	},
/area/shuttle/ert)
"J" = (
/obj/effect/landmark/ert_spawns/distress_pmc,
/obj/effect/mapping_helpers/sunlight/pseudo_roof_setter/ship_hull,
/turf/open/shuttle/dropship{
	icon_state = "rasputin3"
	},
/area/shuttle/ert)
"K" = (
/obj/effect/mapping_helpers/sunlight/pseudo_roof_setter/ship_hull,
/turf/closed/shuttle/ert{
	icon_state = "wy20"
	},
/area/shuttle/ert)
"L" = (
/obj/structure/bed/chair/dropship/passenger{
	dir = 8
	},
/obj/effect/landmark/ert_spawns/distress_pmc,
/obj/effect/mapping_helpers/sunlight/pseudo_roof_setter/ship_hull,
/turf/open/shuttle/dropship{
	icon_state = "rasputin15"
	},
/area/shuttle/ert)
"M" = (
/obj/effect/mapping_helpers/sunlight/pseudo_roof_setter/ship_hull,
/turf/closed/shuttle/ert{
	icon_state = "rightengine_2";
	opacity = 0
	},
/area/shuttle/ert)
"N" = (
/obj/effect/mapping_helpers/sunlight/pseudo_roof_setter/ship_hull,
/turf/closed/shuttle/ert{
	icon_state = "wy9"
	},
/area/shuttle/ert)
"O" = (
/obj/effect/mapping_helpers/sunlight/pseudo_roof_setter/ship_hull,
/obj/structure/machinery/light{
	pixel_x = 0;
	req_light_switch = 0
	},
/turf/open/shuttle/dropship{
	icon_state = "rasputin3"
	},
/area/shuttle/ert)
"P" = (
/obj/effect/mapping_helpers/sunlight/pseudo_roof_setter/ship_hull,
/turf/closed/shuttle/ert{
	icon_state = "leftengine_2";
	opacity = 0
	},
/area/shuttle/ert)
"Q" = (
/obj/structure/surface/rack,
/obj/effect/landmark/ert_spawns/distress_pmc/item,
/obj/item/storage/toolbox/syndicate,
/obj/effect/mapping_helpers/sunlight/pseudo_roof_setter/ship_hull,
/turf/open/shuttle/dropship{
	icon_state = "rasputin15"
	},
/area/shuttle/ert)
"R" = (
/obj/effect/mapping_helpers/sunlight/pseudo_roof_setter/ship_hull,
/turf/closed/shuttle/ert{
	icon_state = "wy14"
	},
/area/shuttle/ert)
"S" = (
/obj/effect/mapping_helpers/sunlight/pseudo_roof_setter/ship_hull,
/turf/closed/shuttle/ert{
	icon_state = "rightengine_3";
	opacity = 0
	},
/area/shuttle/ert)
"T" = (
/obj/effect/mapping_helpers/sunlight/pseudo_roof_setter/ship_hull,
/turf/closed/shuttle/ert{
	icon_state = "wy2"
	},
/area/shuttle/ert)
"U" = (
/obj/effect/mapping_helpers/sunlight/pseudo_roof_setter/ship_hull,
/turf/closed/shuttle/ert{
	icon_state = "wy1"
	},
/area/shuttle/ert)
"V" = (
/obj/structure/bed/chair/dropship/passenger{
	dir = 8
	},
/obj/effect/landmark/ert_spawns/distress_pmc,
/obj/effect/mapping_helpers/sunlight/pseudo_roof_setter/ship_hull,
/obj/structure/machinery/light{
	dir = 8;
	req_light_switch = 0
	},
/turf/open/shuttle/dropship{
	icon_state = "rasputin15"
	},
/area/shuttle/ert)
"X" = (
/obj/effect/mapping_helpers/sunlight/pseudo_roof_setter/ship_hull,
/turf/closed/shuttle/ert{
	icon_state = "wy3"
	},
/area/shuttle/ert)
"Y" = (
/obj/effect/mapping_helpers/sunlight/pseudo_roof_setter/ship_hull,
/turf/open/shuttle/dropship{
	icon_state = "rasputin4"
	},
/area/shuttle/ert)
"Z" = (
/obj/effect/mapping_helpers/sunlight/pseudo_roof_setter/ship_hull,
/turf/closed/shuttle/ert{
	icon_state = "wy18"
	},
/area/shuttle/ert)

(1,1,1) = {"
i
K
Z
t
x
R
j
t
p
b
z
P
o
"}
(2,1,1) = {"
i
c
Q
k
u
C
u
k
f
v
p
p
U
"}
(3,1,1) = {"
K
E
d
J
J
J
J
J
Y
k
k
k
q
"}
(4,1,1) = {"
A
I
G
H
H
H
H
H
G
s
s
O
T
"}
(5,1,1) = {"
y
l
m
J
J
J
J
J
h
k
k
k
q
"}
(6,1,1) = {"
i
c
g
k
L
V
L
k
f
N
r
r
X
"}
(7,1,1) = {"
i
y
F
t
n
D
e
t
r
w
S
M
a
"}
