//MAP CONVERTED BY dmm2tgm.py THIS HEADER COMMENT PREVENTS RECONVERSION, DO NOT REMOVE
"a" = (
/obj/docking_port/mobile/escape_shuttle/w,
/obj/effect/mapping_helpers/sunlight/pseudo_roof_setter/ship_hull,
/turf/closed/shuttle/escapepod{
	icon_state = "wall9"
	},
/area/shuttle/escape_pod)
"b" = (
/obj/effect/mapping_helpers/sunlight/pseudo_roof_setter/ship_hull,
/turf/closed/shuttle/escapepod{
	icon_state = "wall8"
	},
/area/shuttle/escape_pod)
"e" = (
/obj/effect/mapping_helpers/sunlight/pseudo_roof_setter/ship_hull,
/turf/closed/shuttle/escapepod{
	icon_state = "wall6"
	},
/area/shuttle/escape_pod)
"j" = (
/obj/effect/mapping_helpers/sunlight/pseudo_roof_setter/ship_hull,
/turf/closed/shuttle/escapepod{
	icon_state = "wall7"
	},
/area/shuttle/escape_pod)
"o" = (
/obj/effect/mapping_helpers/sunlight/pseudo_roof_setter/ship_hull,
/turf/closed/shuttle/escapepod{
	icon_state = "wall3"
	},
/area/shuttle/escape_pod)
"p" = (
/obj/effect/mapping_helpers/sunlight/pseudo_roof_setter/ship_hull,
/turf/closed/shuttle/escapepod{
	icon_state = "wall2"
	},
/area/shuttle/escape_pod)
"B" = (
/obj/effect/mapping_helpers/sunlight/pseudo_roof_setter/ship_hull,
/turf/closed/shuttle/escapepod{
	icon_state = "wall10"
	},
/area/shuttle/escape_pod)
"F" = (
/obj/effect/mapping_helpers/sunlight/pseudo_roof_setter/ship_hull,
/turf/closed/shuttle/escapepod{
	icon_state = "wall1"
	},
/area/shuttle/escape_pod)
"G" = (
/obj/effect/mapping_helpers/sunlight/pseudo_roof_setter/ship_hull,
/turf/closed/shuttle/escapepod{
	icon_state = "wall4"
	},
/area/shuttle/escape_pod)
"H" = (
/obj/effect/mapping_helpers/sunlight/pseudo_roof_setter/ship_hull,
/turf/open/shuttle/escapepod{
	icon_state = "floor5"
	},
/area/shuttle/escape_pod)
"I" = (
/obj/structure/machinery/cryopod/evacuation,
/obj/structure/sign/safety/cryo{
	pixel_x = 36
	},
/obj/effect/mapping_helpers/sunlight/pseudo_roof_setter/ship_hull,
/turf/open/shuttle/escapepod,
/area/shuttle/escape_pod)
"M" = (
/obj/structure/machinery/cryopod/evacuation,
/obj/effect/mapping_helpers/sunlight/pseudo_roof_setter/ship_hull,
/turf/open/shuttle/escapepod,
/area/shuttle/escape_pod)
"P" = (
/obj/effect/mapping_helpers/sunlight/pseudo_roof_setter/ship_hull,
/turf/closed/shuttle/escapepod{
	icon_state = "wall13"
	},
/area/shuttle/escape_pod)
"S" = (
/obj/structure/machinery/door/airlock/evacuation{
	name = "\improper Evacuation Airlock PL-3"
	},
/obj/effect/mapping_helpers/sunlight/pseudo_roof_setter/ship_hull,
/turf/open/floor/almayer{
	icon_state = "test_floor4"
	},
/area/shuttle/escape_pod)
"V" = (
/obj/structure/machinery/computer/shuttle/escape_pod_panel{
	pixel_y = 30
	},
/obj/effect/mapping_helpers/sunlight/pseudo_roof_setter/ship_hull,
/turf/open/shuttle/escapepod{
	icon_state = "floor4"
	},
/area/shuttle/escape_pod)
"W" = (
/obj/effect/mapping_helpers/sunlight/pseudo_roof_setter/ship_hull,
/obj/structure/machinery/light{
	pixel_x = 0;
	req_light_switch = 0
	},
/turf/open/shuttle/escapepod{
	icon_state = "floor12"
	},
/area/shuttle/escape_pod)

(1,1,1) = {"
P
B
S
B
a
"}
(2,1,1) = {"
F
V
H
W
b
"}
(3,1,1) = {"
p
M
I
M
j
"}
(4,1,1) = {"
o
G
G
G
e
"}
