//MAP CONVERTED BY dmm2tgm.py THIS HEADER COMMENT PREVENTS RECONVERSION, DO NOT REMOVE
"a" = (
/obj/docking_port/mobile/sselevator/one,
/turf/closed/shuttle/elevator/window{
	dir = 10;
	icon_state = "wall_window_w"
	},
/area/shuttle/sky_scraper_elevator)
"b" = (
/obj/structure/machinery/gear/sky_scraper{
	dir = 4
	},
/turf/closed/shuttle/elevator/gears/sci{
	dir = 4
	},
/area/shuttle/sky_scraper_elevator)
"c" = (
/turf/closed/shuttle/elevator/window{
	dir = 1;
	icon_state = "wall_window_w"
	},
/area/shuttle/sky_scraper_elevator)
"d" = (
/obj/structure/machinery/door/airlock/multi_tile/almayer/dropshiprear/blastdoor/elevator{
	floor = "control";
	density = 0
	},
/turf/open/shuttle/elevator{
	icon_state = "floor_w_g"
	},
/area/shuttle/sky_scraper_elevator)
"i" = (
/turf/closed/shuttle/elevator/window{
	icon_state = "wall_window_w"
	},
/area/shuttle/sky_scraper_elevator)
"k" = (
/turf/closed/shuttle/elevator/window{
	dir = 1;
	icon_state = "wall_windowa_w"
	},
/area/shuttle/sky_scraper_elevator)
"o" = (
/turf/closed/shuttle/elevator/window{
	dir = 6;
	icon_state = "wall_window_w"
	},
/area/shuttle/sky_scraper_elevator)
"p" = (
/turf/closed/shuttle/elevator{
	dir = 4;
	icon_state = "wall_w";
	tag = "icon-wall (EAST)"
	},
/area/shuttle/sky_scraper_elevator)
"q" = (
/turf/open/shuttle/elevator{
	icon_state = "floor_w_v"
	},
/area/shuttle/sky_scraper_elevator)
"s" = (
/turf/closed/shuttle/elevator/window{
	icon_state = "wall_windowa_w"
	},
/area/shuttle/sky_scraper_elevator)
"t" = (
/obj/structure/machinery/light/double/blue{
	req_light_switch = 0
	},
/turf/open/shuttle/elevator/grating{
	icon_state = "floor_grating_w"
	},
/area/shuttle/sky_scraper_elevator)
"v" = (
/turf/closed/shuttle/elevator/window{
	dir = 9;
	icon_state = "wall_window_w"
	},
/area/shuttle/sky_scraper_elevator)
"w" = (
/turf/closed/shuttle/elevator/window{
	dir = 8;
	icon_state = "wall_window_w"
	},
/area/shuttle/sky_scraper_elevator)
"F" = (
/turf/closed/shuttle/elevator/window{
	dir = 5;
	icon_state = "wall_window_w"
	},
/area/shuttle/sky_scraper_elevator)
"H" = (
/turf/open/shuttle/elevator{
	icon_state = "floor_w_g"
	},
/area/shuttle/sky_scraper_elevator)
"K" = (
/turf/open/shuttle/elevator/grating{
	icon_state = "floor_grating_w"
	},
/area/shuttle/sky_scraper_elevator)
"S" = (
/obj/structure/machinery/gear/sky_scraper,
/turf/closed/shuttle/elevator/gears/sci,
/area/shuttle/sky_scraper_elevator)
"U" = (
/obj/structure/machinery/computer/shuttle/shuttle_control/sselevator{
	elevator_id = "sky_scraper_elevator_one";
	floor = "control";
	pixel_y = 38
	},
/turf/open/shuttle/elevator{
	icon_state = "floor_w_v"
	},
/area/shuttle/sky_scraper_elevator)

(1,1,1) = {"
v
i
i
i
i
k
a
"}
(2,1,1) = {"
p
q
K
K
K
q
w
"}
(3,1,1) = {"
d
K
K
K
K
K
S
"}
(4,1,1) = {"
H
K
q
q
q
t
p
"}
(5,1,1) = {"
H
K
K
K
K
K
b
"}
(6,1,1) = {"
p
U
K
K
K
q
w
"}
(7,1,1) = {"
F
c
c
c
c
s
o
"}
