//MAP CONVERTED BY dmm2tgm.py THIS HEADER COMMENT PREVENTS RECONVERSION, DO NOT REMOVE
"a" = (
/obj/structure/interior_wall/apc{
	icon_state = "rear_2"
	},
/obj/effect/mapping_helpers/sunlight/pseudo_roof_setter/ship_hull,
/turf/open/void/densy,
/area/space)
"b" = (
/obj/structure/bed/chair/vehicle{
	dir = 1;
	pixel_x = 8
	},
/obj/structure/bed/chair/vehicle{
	dir = 1;
	pixel_x = -8
	},
/obj/effect/mapping_helpers/sunlight/pseudo_roof_setter/ship_hull,
/turf/open/shuttle/vehicle{
	icon_state = "floor_3_13"
	},
/area/vehicle/apc)
"c" = (
/obj/structure/bed/chair/vehicle{
	dir = 1;
	pixel_x = -8
	},
/obj/structure/bed/chair/vehicle{
	dir = 1;
	pixel_x = 8
	},
/obj/effect/landmark/interior/spawn/interior_viewport{
	dir = 1;
	pixel_x = 8;
	pixel_y = -11
	},
/obj/effect/mapping_helpers/sunlight/pseudo_roof_setter/ship_hull,
/turf/open/shuttle/vehicle{
	icon_state = "floor_3_5"
	},
/area/vehicle/apc)
"d" = (
/obj/structure/bed/chair/vehicle{
	dir = 1;
	pixel_x = 8
	},
/obj/structure/bed/chair/vehicle{
	dir = 1;
	pixel_x = -8
	},
/obj/effect/mapping_helpers/sunlight/pseudo_roof_setter/ship_hull,
/turf/open/shuttle/vehicle{
	icon_state = "floor_3_8_1"
	},
/area/vehicle/apc)
"e" = (
/obj/structure/interior_wall/apc{
	icon_state = "rear_1"
	},
/obj/effect/mapping_helpers/sunlight/pseudo_roof_setter/ship_hull,
/turf/open/void/densy,
/area/space)
"f" = (
/obj/effect/landmark/interior/spawn/vehicle_support_gunner_seat/second,
/obj/structure/prop/vehicle/firing_port_weapon{
	layer = 4.1;
	name = "Right M56 FPW handle";
	pixel_y = 2
	},
/obj/effect/mapping_helpers/sunlight/pseudo_roof_setter/ship_hull,
/turf/open/shuttle/vehicle{
	icon_state = "floor_3_12"
	},
/area/vehicle/apc)
"g" = (
/obj/structure/interior_wall/apc{
	icon_state = "corner_small_R"
	},
/obj/structure/interior_wall/apc{
	icon_state = "front_5"
	},
/obj/effect/mapping_helpers/sunlight/pseudo_roof_setter/ship_hull,
/turf/open/void/densy,
/area/space)
"h" = (
/obj/structure/interior_wall/apc{
	icon_state = "rear_wheel_R";
	opacity = 0
	},
/obj/effect/mapping_helpers/sunlight/pseudo_roof_setter/ship_hull,
/turf/open/void/densy,
/area/space)
"i" = (
/obj/effect/mapping_helpers/sunlight/pseudo_roof_setter/ship_hull,
/turf/open/shuttle/vehicle{
	icon_state = "floor_0_1_15"
	},
/area/vehicle/apc)
"j" = (
/obj/effect/mapping_helpers/sunlight/pseudo_roof_setter/ship_hull,
/turf/open/void/densy,
/area/space)
"k" = (
/obj/structure/interior_wall/apc{
	icon_state = "rear_wheel_L"
	},
/obj/effect/mapping_helpers/sunlight/pseudo_roof_setter/ship_hull,
/turf/open/void/densy,
/area/space)
"l" = (
/obj/structure/interior_wall/apc{
	alpha = 100;
	icon_state = "wall_door_front";
	layer = 5.2;
	pixel_y = 32
	},
/obj/effect/mapping_helpers/sunlight/pseudo_roof_setter/ship_hull,
/turf/open/void/densy,
/area/space)
"m" = (
/obj/effect/landmark/interior/spawn/vehicle_driver_seat/armor{
	dir = 4
	},
/obj/effect/mapping_helpers/sunlight/pseudo_roof_setter/ship_hull,
/turf/open/shuttle/vehicle{
	icon_state = "floor_3_9_1"
	},
/area/vehicle/apc)
"n" = (
/obj/structure/interior_wall/apc{
	icon_state = "front_2"
	},
/obj/effect/mapping_helpers/sunlight/pseudo_roof_setter/ship_hull,
/turf/open/void/densy,
/area/space)
"o" = (
/obj/structure/interior_wall/apc{
	icon_state = "front_wheel_L";
	opacity = 0
	},
/obj/effect/mapping_helpers/sunlight/pseudo_roof_setter/ship_hull,
/turf/open/void/densy,
/area/space)
"p" = (
/obj/structure/interior_wall/apc{
	icon_state = "front_4"
	},
/obj/effect/mapping_helpers/sunlight/pseudo_roof_setter/ship_hull,
/turf/open/void/densy,
/area/space)
"q" = (
/obj/structure/interior_wall/apc{
	icon_state = "front_3"
	},
/obj/effect/mapping_helpers/sunlight/pseudo_roof_setter/ship_hull,
/turf/open/void/densy,
/area/space)
"r" = (
/obj/structure/interior_wall/apc{
	icon_state = "corner_inverse_L";
	opacity = 0
	},
/obj/effect/mapping_helpers/sunlight/pseudo_roof_setter/ship_hull,
/turf/open/void/densy,
/area/space)
"s" = (
/obj/effect/landmark/interior/spawn/entrance{
	dir = 8;
	exit_type = /obj/structure/interior_exit/vehicle/apc/rear;
	pixel_x = -32
	},
/obj/structure/machinery/light{
	dir = 8;
	req_light_switch = 0
	},
/obj/effect/mapping_helpers/sunlight/pseudo_roof_setter/ship_hull,
/turf/open/shuttle/vehicle{
	icon_state = "floor_1_13"
	},
/area/vehicle/apc)
"t" = (
/obj/structure/interior_wall/apc{
	icon_state = "rear_3"
	},
/obj/effect/mapping_helpers/sunlight/pseudo_roof_setter/ship_hull,
/turf/open/void/densy,
/area/space)
"u" = (
/obj/effect/landmark/interior/spawn/weapons_loader,
/obj/structure/machinery/light{
	dir = 4;
	req_light_switch = 0
	},
/obj/effect/mapping_helpers/sunlight/pseudo_roof_setter/ship_hull,
/turf/open/shuttle/vehicle{
	icon_state = "floor_3_6"
	},
/area/vehicle/apc)
"v" = (
/obj/structure/bed/chair/vehicle{
	pixel_x = 8
	},
/obj/structure/bed/chair/vehicle{
	pixel_x = -8
	},
/obj/effect/landmark/interior/spawn/interior_camera{
	dir = 10;
	pixel_x = -14;
	pixel_y = 38
	},
/obj/effect/mapping_helpers/sunlight/pseudo_roof_setter/ship_hull,
/turf/open/shuttle/vehicle{
	icon_state = "floor_3_9_1"
	},
/area/vehicle/apc)
"w" = (
/obj/effect/landmark/interior/spawn/entrance{
	alpha = 50;
	dir = 1;
	exit_type = /obj/structure/interior_exit/vehicle/apc;
	name = "Left APC door";
	pixel_y = 32
	},
/obj/effect/landmark/interior/spawn/interior_viewport{
	dir = 8;
	pixel_x = 5;
	pixel_y = 8
	},
/obj/effect/mapping_helpers/sunlight/pseudo_roof_setter/ship_hull,
/turf/open/shuttle/vehicle{
	icon_state = "floor_1_11"
	},
/area/vehicle/apc)
"y" = (
/obj/structure/interior_wall/apc{
	icon_state = "front_6"
	},
/obj/effect/mapping_helpers/sunlight/pseudo_roof_setter/ship_hull,
/turf/open/void/densy,
/area/space)
"z" = (
/obj/effect/mapping_helpers/sunlight/pseudo_roof_setter/ship_hull,
/turf/open/shuttle/vehicle{
	icon_state = "floor_1_5"
	},
/area/vehicle/apc)
"A" = (
/obj/effect/mapping_helpers/sunlight/pseudo_roof_setter/ship_hull,
/turf/open/shuttle/vehicle{
	icon_state = "floor_1_6"
	},
/area/vehicle/apc)
"B" = (
/obj/structure/interior_wall/apc{
	icon_state = "corner_inverse_R";
	opacity = 0
	},
/obj/effect/mapping_helpers/sunlight/pseudo_roof_setter/ship_hull,
/turf/open/void/densy,
/area/space)
"C" = (
/obj/structure/machinery/cm_vending/sorted/vehicle_supply{
	pixel_y = 20
	},
/obj/structure/machinery/cm_vending/sorted/medical/wall_med/vehicle{
	pixel_x = -24;
	pixel_y = 28
	},
/obj/effect/mapping_helpers/sunlight/pseudo_roof_setter/ship_hull,
/turf/open/shuttle/vehicle{
	icon_state = "floor_1_11"
	},
/area/vehicle/apc)
"D" = (
/obj/structure/interior_wall/apc{
	icon_state = "wall";
	opacity = 0
	},
/obj/effect/mapping_helpers/sunlight/pseudo_roof_setter/ship_hull,
/turf/open/void/densy,
/area/space)
"E" = (
/obj/structure/interior_wall/apc{
	icon_state = "corner_small_R";
	opacity = 0
	},
/obj/structure/interior_wall/apc{
	icon_state = "wheel_front_top_2";
	pixel_x = 4;
	pixel_y = -4
	},
/obj/effect/mapping_helpers/sunlight/pseudo_roof_setter/ship_hull,
/turf/open/void/densy,
/area/space)
"F" = (
/obj/effect/landmark/interior/spawn/entrance{
	dir = 8;
	exit_type = /obj/structure/interior_exit/vehicle/apc/rear/right;
	pixel_x = -32
	},
/obj/structure/bed/chair/vehicle{
	dir = 1;
	pixel_x = -8
	},
/obj/structure/bed/chair/vehicle{
	dir = 1;
	pixel_x = 8
	},
/obj/effect/mapping_helpers/sunlight/pseudo_roof_setter/ship_hull,
/turf/open/shuttle/vehicle{
	icon_state = "floor_3_13"
	},
/area/vehicle/apc)
"H" = (
/obj/structure/bed/chair/vehicle{
	pixel_x = -8
	},
/obj/structure/bed/chair/vehicle{
	pixel_x = 8
	},
/obj/effect/landmark/interior/spawn/telephone{
	pixel_x = 5;
	pixel_y = 30
	},
/obj/structure/extinguisher_cabinet/lifeboat{
	icon = 'icons/obj/vehicles/interiors/general.dmi';
	pixel_x = -8;
	pixel_y = 28
	},
/obj/effect/mapping_helpers/sunlight/pseudo_roof_setter/ship_hull,
/turf/open/shuttle/vehicle{
	icon_state = "floor_3_13"
	},
/area/vehicle/apc)
"I" = (
/obj/effect/landmark/interior/spawn/vehicle_support_gunner_seat{
	dir = 1
	},
/obj/structure/prop/vehicle/firing_port_weapon{
	dir = 1;
	name = "Left M56 FPW handle";
	pixel_y = 17
	},
/obj/effect/mapping_helpers/sunlight/pseudo_roof_setter/ship_hull,
/turf/open/shuttle/vehicle{
	icon_state = "floor_3_11"
	},
/area/vehicle/apc)
"J" = (
/obj/structure/interior_wall/apc{
	icon_state = "corner_small_L";
	opacity = 0
	},
/obj/structure/interior_wall/apc{
	icon_state = "wheel_back_top_2";
	pixel_x = -4;
	pixel_y = -4
	},
/obj/effect/mapping_helpers/sunlight/pseudo_roof_setter/ship_hull,
/turf/open/void/densy,
/area/space)
"K" = (
/obj/effect/mapping_helpers/sunlight/pseudo_roof_setter/ship_hull,
/turf/open/shuttle/vehicle{
	icon_state = "floor_1_14"
	},
/area/vehicle/apc)
"L" = (
/obj/structure/interior_wall/apc{
	icon_state = "corner_small_L"
	},
/obj/structure/interior_wall/apc{
	icon_state = "rear_5"
	},
/obj/effect/mapping_helpers/sunlight/pseudo_roof_setter/ship_hull,
/turf/open/void/densy,
/area/space)
"M" = (
/obj/structure/interior_wall/apc{
	icon_state = "front_1"
	},
/obj/effect/mapping_helpers/sunlight/pseudo_roof_setter/ship_hull,
/turf/open/void/densy,
/area/space)
"N" = (
/obj/structure/interior_wall/apc{
	icon_state = "wheel_front_top_1";
	pixel_x = 1;
	pixel_y = -4
	},
/obj/effect/mapping_helpers/sunlight/pseudo_roof_setter/ship_hull,
/turf/open/void/densy,
/area/space)
"O" = (
/obj/structure/interior_wall/apc{
	icon_state = "door_back"
	},
/obj/effect/mapping_helpers/sunlight/pseudo_roof_setter/ship_hull,
/turf/open/void/densy,
/area/space)
"P" = (
/obj/structure/interior_wall/apc{
	icon_state = "rear_6"
	},
/obj/effect/mapping_helpers/sunlight/pseudo_roof_setter/ship_hull,
/turf/open/void/densy,
/area/space)
"R" = (
/obj/effect/mapping_helpers/sunlight/pseudo_roof_setter/ship_hull,
/turf/open/shuttle/vehicle{
	icon_state = "floor_1_1_3"
	},
/area/vehicle/apc)
"S" = (
/obj/structure/interior_wall/apc{
	alpha = 100;
	icon_state = "door_front";
	layer = 5.2;
	pixel_y = 32
	},
/obj/effect/mapping_helpers/sunlight/pseudo_roof_setter/ship_hull,
/turf/open/void/densy,
/area/space)
"T" = (
/obj/structure/interior_wall/apc{
	icon_state = "wheel_back_top_1";
	pixel_x = -4;
	pixel_y = -4
	},
/obj/effect/mapping_helpers/sunlight/pseudo_roof_setter/ship_hull,
/turf/open/void/densy,
/area/space)
"U" = (
/obj/effect/landmark/interior/spawn/entrance{
	dir = 8;
	exit_type = /obj/structure/interior_exit/vehicle/apc/rear/left;
	pixel_x = -32
	},
/obj/structure/bed/chair/vehicle{
	pixel_x = -8
	},
/obj/structure/bed/chair/vehicle{
	pixel_x = 8
	},
/obj/effect/landmark/interior/spawn/interior_viewport{
	pixel_x = -7;
	pixel_y = 23
	},
/obj/effect/mapping_helpers/sunlight/pseudo_roof_setter/ship_hull,
/turf/open/shuttle/vehicle{
	icon_state = "floor_3_13"
	},
/area/vehicle/apc)
"V" = (
/obj/structure/interior_wall/apc{
	icon_state = "wall"
	},
/obj/effect/mapping_helpers/sunlight/pseudo_roof_setter/ship_hull,
/turf/open/void/densy,
/area/space)
"W" = (
/obj/effect/landmark/interior/spawn/vehicle_gunner_seat/armor{
	dir = 4
	},
/obj/structure/vehicle_locker{
	layer = 5.21;
	pixel_y = 28
	},
/obj/effect/mapping_helpers/sunlight/pseudo_roof_setter/ship_hull,
/turf/open/shuttle/vehicle{
	icon_state = "floor_3_8_1"
	},
/area/vehicle/apc)
"X" = (
/obj/structure/interior_wall/apc{
	icon_state = "front_wheel_R"
	},
/obj/effect/mapping_helpers/sunlight/pseudo_roof_setter/ship_hull,
/turf/open/void/densy,
/area/space)
"Y" = (
/obj/effect/landmark/interior/spawn/entrance{
	alpha = 50;
	exit_type = /obj/structure/interior_exit/vehicle/apc;
	name = "Right APC door"
	},
/obj/effect/landmark/interior/spawn/interior_viewport{
	dir = 8;
	pixel_x = 5;
	pixel_y = 1
	},
/obj/effect/mapping_helpers/sunlight/pseudo_roof_setter/ship_hull,
/turf/open/shuttle/vehicle{
	icon_state = "floor_1_12"
	},
/area/vehicle/apc)
"Z" = (
/obj/structure/interior_wall/apc{
	icon_state = "rear_4"
	},
/obj/effect/mapping_helpers/sunlight/pseudo_roof_setter/ship_hull,
/turf/open/void/densy,
/area/space)

(1,1,1) = {"
P
L
Z
t
a
e
j
"}
(2,1,1) = {"
T
D
U
s
F
k
j
"}
(3,1,1) = {"
J
r
C
R
c
h
j
"}
(4,1,1) = {"
V
I
v
z
d
f
l
"}
(5,1,1) = {"
O
w
A
i
A
Y
S
"}
(6,1,1) = {"
E
B
H
K
b
o
j
"}
(7,1,1) = {"
N
D
W
u
m
X
j
"}
(8,1,1) = {"
y
g
p
q
n
M
j
"}
