//MAP CONVERTED BY dmm2tgm.py THIS HEADER COMMENT PREVENTS RECONVERSION, DO NOT REMOVE
"a" = (
/obj/structure/interior_wall/apc{
	icon_state = "rear_2"
	},
/obj/effect/mapping_helpers/sunlight/pseudo_roof_setter/ship_hull,
/turf/open/void/vehicle,
/area/space)
"b" = (
/obj/structure/surface/table/reinforced/prison,
/obj/structure/machinery/recharger{
	pixel_x = -5
	},
/obj/item/device/defibrillator,
/obj/effect/mapping_helpers/sunlight/pseudo_roof_setter/ship_hull,
/turf/open/shuttle/vehicle{
	icon_state = "dark_sterile_green_11"
	},
/area/vehicle/apc/med)
"c" = (
/obj/effect/decal/medical_decals/permanent{
	icon_state = "docdecal2";
	pixel_x = -5;
	pixel_y = 16
	},
/obj/effect/decal/medical_decals/permanent{
	icon_state = "triagedecalbottom"
	},
/obj/effect/mapping_helpers/sunlight/pseudo_roof_setter/ship_hull,
/turf/open/shuttle/vehicle{
	icon_state = "dark_sterile_green_5"
	},
/area/vehicle/apc/med)
"d" = (
/obj/effect/decal/medical_decals/permanent{
	icon_state = "triagedecalbottom"
	},
/obj/effect/decal/medical_decals/permanent{
	icon_state = "triagedecaltopright"
	},
/obj/effect/mapping_helpers/sunlight/pseudo_roof_setter/ship_hull,
/turf/open/shuttle/vehicle{
	icon_state = "dark_sterile_green_14"
	},
/area/vehicle/apc/med)
"e" = (
/obj/structure/interior_wall/apc{
	icon_state = "rear_1"
	},
/obj/effect/mapping_helpers/sunlight/pseudo_roof_setter/ship_hull,
/turf/open/void/vehicle,
/area/space)
"f" = (
/obj/structure/interior_wall/apc{
	icon_state = "rear_wheel_L"
	},
/obj/effect/mapping_helpers/sunlight/pseudo_roof_setter/ship_hull,
/turf/open/void/vehicle,
/area/space)
"g" = (
/obj/structure/interior_wall/apc{
	icon_state = "rear_wheel_R";
	opacity = 0
	},
/obj/effect/mapping_helpers/sunlight/pseudo_roof_setter/ship_hull,
/turf/open/void/vehicle,
/area/space)
"h" = (
/obj/structure/bed/chair/vehicle{
	dir = 1;
	pixel_x = 8
	},
/obj/structure/bed/chair/vehicle{
	dir = 1;
	pixel_x = -8
	},
/obj/effect/mapping_helpers/sunlight/pseudo_roof_setter/ship_hull,
/turf/open/shuttle/vehicle{
	icon_state = "floor_3"
	},
/area/vehicle/apc/med)
"j" = (
/obj/structure/interior_wall/apc{
	icon_state = "rear_6"
	},
/obj/effect/mapping_helpers/sunlight/pseudo_roof_setter/ship_hull,
/turf/open/void/vehicle,
/area/space)
"k" = (
/obj/effect/mapping_helpers/sunlight/pseudo_roof_setter/ship_hull,
/turf/open/void/vehicle,
/area/space)
"l" = (
/obj/structure/interior_wall/apc{
	alpha = 100;
	icon_state = "wall_door_front";
	layer = 5.2;
	pixel_y = 32
	},
/obj/effect/mapping_helpers/sunlight/pseudo_roof_setter/ship_hull,
/turf/open/void/vehicle,
/area/space)
"m" = (
/obj/structure/machinery/cm_vending/sorted/medical/blood/vehicle{
	pixel_x = -20;
	pixel_y = 23
	},
/obj/structure/machinery/cm_vending/sorted/medical/vehicle{
	pixel_x = 2;
	pixel_y = 23
	},
/obj/effect/decal/medical_decals/permanent{
	icon_state = "triagedecaltop";
	pixel_y = -2
	},
/obj/effect/mapping_helpers/sunlight/pseudo_roof_setter/ship_hull,
/obj/structure/machinery/iv_drip,
/turf/open/shuttle/vehicle{
	icon_state = "dark_sterile_green_7"
	},
/area/vehicle/apc/med)
"n" = (
/obj/structure/interior_wall/apc{
	icon_state = "wheel_back_top_1";
	pixel_x = -4;
	pixel_y = -4
	},
/obj/effect/mapping_helpers/sunlight/pseudo_roof_setter/ship_hull,
/turf/open/void/vehicle,
/area/space)
"p" = (
/obj/structure/interior_wall/apc{
	icon_state = "wall"
	},
/obj/effect/mapping_helpers/sunlight/pseudo_roof_setter/ship_hull,
/turf/open/void/vehicle,
/area/space)
"q" = (
/obj/structure/interior_wall/apc{
	icon_state = "corner_small_R";
	opacity = 0
	},
/obj/structure/interior_wall/apc{
	icon_state = "wheel_front_top_2";
	pixel_x = 4;
	pixel_y = -4
	},
/obj/effect/mapping_helpers/sunlight/pseudo_roof_setter/ship_hull,
/turf/open/void/vehicle,
/area/space)
"r" = (
/obj/structure/interior_wall/apc{
	icon_state = "corner_small_R"
	},
/obj/structure/interior_wall/apc{
	icon_state = "front_5"
	},
/obj/effect/mapping_helpers/sunlight/pseudo_roof_setter/ship_hull,
/turf/open/void/vehicle,
/area/space)
"s" = (
/obj/structure/interior_wall/apc{
	icon_state = "front_6"
	},
/obj/effect/mapping_helpers/sunlight/pseudo_roof_setter/ship_hull,
/turf/open/void/vehicle,
/area/space)
"t" = (
/obj/structure/interior_wall/apc{
	icon_state = "rear_3"
	},
/obj/effect/mapping_helpers/sunlight/pseudo_roof_setter/ship_hull,
/turf/open/void/vehicle,
/area/space)
"u" = (
/obj/structure/interior_wall/apc{
	icon_state = "corner_small_L";
	opacity = 0
	},
/obj/structure/interior_wall/apc{
	icon_state = "wheel_back_top_2";
	pixel_x = -4;
	pixel_y = -4
	},
/obj/effect/mapping_helpers/sunlight/pseudo_roof_setter/ship_hull,
/turf/open/void/vehicle,
/area/space)
"v" = (
/obj/structure/interior_wall/apc{
	icon_state = "front_3"
	},
/obj/effect/mapping_helpers/sunlight/pseudo_roof_setter/ship_hull,
/turf/open/void/vehicle,
/area/space)
"w" = (
/obj/effect/decal/medical_decals/permanent{
	dir = 4;
	icon_state = "triagedecaldir"
	},
/obj/effect/mapping_helpers/sunlight/pseudo_roof_setter/ship_hull,
/obj/structure/machinery/medical_pod/bodyscanner,
/turf/open/shuttle/vehicle{
	icon_state = "dark_sterile_green_8"
	},
/area/vehicle/apc/med)
"x" = (
/obj/structure/interior_wall/apc{
	icon_state = "wall";
	opacity = 0
	},
/obj/effect/mapping_helpers/sunlight/pseudo_roof_setter/ship_hull,
/turf/open/void/vehicle,
/area/space)
"y" = (
/obj/effect/landmark/interior/spawn/interior_viewport{
	dir = 8;
	pixel_x = 5;
	pixel_y = 8
	},
/obj/effect/landmark/interior/spawn/entrance{
	alpha = 50;
	dir = 1;
	exit_type = /obj/structure/interior_exit/vehicle/apc;
	name = "Left APC door";
	pixel_y = 32;
	tag = "left"
	},
/obj/effect/mapping_helpers/sunlight/pseudo_roof_setter/ship_hull,
/turf/open/shuttle/vehicle{
	icon_state = "floor_1_11"
	},
/area/vehicle/apc/med)
"z" = (
/obj/structure/interior_wall/apc{
	icon_state = "wheel_front_top_1";
	pixel_x = 1;
	pixel_y = -4
	},
/obj/effect/mapping_helpers/sunlight/pseudo_roof_setter/ship_hull,
/turf/open/void/vehicle,
/area/space)
"A" = (
/obj/structure/bed/chair/vehicle{
	pixel_x = 8
	},
/obj/structure/bed/chair/vehicle{
	pixel_x = -8
	},
/obj/effect/mapping_helpers/sunlight/pseudo_roof_setter/ship_hull,
/turf/open/shuttle/vehicle{
	icon_state = "floor_3"
	},
/area/vehicle/apc/med)
"B" = (
/obj/effect/landmark/interior/spawn/interior_viewport{
	pixel_x = -6;
	pixel_y = 23
	},
/obj/effect/mapping_helpers/sunlight/pseudo_roof_setter/ship_hull,
/obj/structure/surface/table/reinforced/prison,
/obj/item/tool/surgery/surgicaldrill,
/obj/item/tool/surgery/surgical_line,
/obj/item/tool/surgery/scalpel,
/obj/item/tool/surgery/retractor,
/obj/item/tool/surgery/hemostat,
/obj/item/tool/surgery/circular_saw,
/obj/item/tool/surgery/cautery,
/obj/item/tool/surgery/bonesetter,
/obj/item/tool/surgery/bonegel,
/obj/item/tool/surgery/FixOVein,
/turf/open/shuttle/vehicle{
	icon_state = "dark_sterile_green_12"
	},
/area/vehicle/apc/med)
"C" = (
/obj/structure/interior_wall/apc{
	icon_state = "front_wheel_L";
	opacity = 0
	},
/obj/effect/mapping_helpers/sunlight/pseudo_roof_setter/ship_hull,
/turf/open/void/vehicle,
/area/space)
"D" = (
/obj/effect/decal/medical_decals/permanent{
	icon_state = "docdecal1";
	pixel_x = -5;
	pixel_y = 16
	},
/obj/effect/mapping_helpers/sunlight/pseudo_roof_setter/ship_hull,
/obj/structure/machinery/sleep_console{
	dir = 8
	},
/turf/open/shuttle/vehicle{
	icon_state = "dark_sterile"
	},
/area/vehicle/apc/med)
"E" = (
/obj/structure/vehicle_locker{
	pixel_y = 28
	},
/obj/effect/landmark/interior/spawn/vehicle_gunner_seat/armor{
	dir = 4
	},
/obj/effect/mapping_helpers/sunlight/pseudo_roof_setter/ship_hull,
/turf/open/shuttle/vehicle{
	icon_state = "floor_3_8_1"
	},
/area/vehicle/apc/med)
"F" = (
/obj/structure/interior_wall/apc{
	icon_state = "front_2"
	},
/obj/effect/mapping_helpers/sunlight/pseudo_roof_setter/ship_hull,
/turf/open/void/vehicle,
/area/space)
"G" = (
/obj/structure/interior_wall/apc{
	alpha = 100;
	icon_state = "door_front";
	layer = 5.2;
	pixel_y = 32
	},
/obj/effect/mapping_helpers/sunlight/pseudo_roof_setter/ship_hull,
/turf/open/void/vehicle,
/area/space)
"H" = (
/obj/structure/interior_wall/apc{
	icon_state = "front_wheel_R"
	},
/obj/effect/mapping_helpers/sunlight/pseudo_roof_setter/ship_hull,
/turf/open/void/vehicle,
/area/space)
"I" = (
/obj/effect/landmark/interior/spawn/vehicle_driver_seat/armor{
	dir = 4
	},
/obj/effect/mapping_helpers/sunlight/pseudo_roof_setter/ship_hull,
/turf/open/shuttle/vehicle{
	icon_state = "floor_3_9_1"
	},
/area/vehicle/apc/med)
"J" = (
/obj/structure/machinery/light{
	dir = 8;
	req_light_switch = 0
	},
/obj/effect/mapping_helpers/sunlight/pseudo_roof_setter/ship_hull,
/obj/structure/machinery/optable,
/turf/open/shuttle/vehicle{
	icon_state = "dark_sterile_green_6"
	},
/area/vehicle/apc/med)
"K" = (
/obj/effect/landmark/interior/spawn/entrance{
	alpha = 50;
	exit_type = /obj/structure/interior_exit/vehicle/apc;
	name = "Right APC door";
	tag = "right"
	},
/obj/effect/landmark/interior/spawn/interior_viewport{
	dir = 8;
	pixel_x = 5;
	pixel_y = 1
	},
/obj/effect/mapping_helpers/sunlight/pseudo_roof_setter/ship_hull,
/turf/open/shuttle/vehicle{
	icon_state = "floor_1_12"
	},
/area/vehicle/apc/med)
"L" = (
/obj/effect/mapping_helpers/sunlight/pseudo_roof_setter/ship_hull,
/turf/open/shuttle/vehicle{
	icon_state = "floor_1_14"
	},
/area/vehicle/apc/med)
"M" = (
/obj/structure/interior_wall/apc{
	icon_state = "corner_inverse_L";
	opacity = 0
	},
/obj/effect/mapping_helpers/sunlight/pseudo_roof_setter/ship_hull,
/turf/open/void/vehicle,
/area/space)
"N" = (
/obj/structure/interior_wall/apc{
	icon_state = "corner_small_L"
	},
/obj/structure/interior_wall/apc{
	icon_state = "rear_5"
	},
/obj/effect/mapping_helpers/sunlight/pseudo_roof_setter/ship_hull,
/turf/open/void/vehicle,
/area/space)
"O" = (
/obj/effect/decal/medical_decals/permanent{
	icon_state = "triagedecaltop";
	pixel_y = -2
	},
/obj/effect/decal/medical_decals/permanent{
	icon_state = "triagedecalbottomright"
	},
/obj/effect/landmark/interior/spawn/interior_camera{
	dir = 10;
	pixel_x = -14;
	pixel_y = 38
	},
/obj/effect/mapping_helpers/sunlight/pseudo_roof_setter/ship_hull,
/turf/open/shuttle/vehicle{
	icon_state = "dark_sterile_green_13"
	},
/area/vehicle/apc/med)
"P" = (
/obj/structure/interior_wall/apc{
	icon_state = "door_back"
	},
/obj/effect/mapping_helpers/sunlight/pseudo_roof_setter/ship_hull,
/turf/open/void/vehicle,
/area/space)
"Q" = (
/obj/effect/mapping_helpers/sunlight/pseudo_roof_setter/ship_hull,
/turf/open/shuttle/vehicle{
	icon_state = "floor_1_6"
	},
/area/vehicle/apc/med)
"R" = (
/obj/effect/landmark/interior/spawn/weapons_loader,
/obj/structure/machinery/light{
	dir = 4;
	req_light_switch = 0
	},
/obj/effect/mapping_helpers/sunlight/pseudo_roof_setter/ship_hull,
/turf/open/shuttle/vehicle{
	icon_state = "floor_3_6"
	},
/area/vehicle/apc/med)
"S" = (
/obj/structure/interior_wall/apc{
	icon_state = "front_4"
	},
/obj/effect/mapping_helpers/sunlight/pseudo_roof_setter/ship_hull,
/turf/open/void/vehicle,
/area/space)
"T" = (
/obj/effect/mapping_helpers/sunlight/pseudo_roof_setter/ship_hull,
/turf/open/shuttle/vehicle{
	icon_state = "floor_1_3_3"
	},
/area/vehicle/apc/med)
"U" = (
/obj/structure/interior_wall/apc{
	icon_state = "front_1"
	},
/obj/effect/mapping_helpers/sunlight/pseudo_roof_setter/ship_hull,
/turf/open/void/vehicle,
/area/space)
"V" = (
/obj/structure/bed/chair/vehicle{
	dir = 1;
	pixel_x = 9
	},
/obj/structure/bed/chair/vehicle{
	dir = 1;
	pixel_x = -7
	},
/obj/effect/mapping_helpers/sunlight/pseudo_roof_setter/ship_hull,
/turf/open/shuttle/vehicle{
	icon_state = "floor_3_13"
	},
/area/vehicle/apc/med)
"W" = (
/obj/structure/bed/chair/vehicle{
	pixel_x = -8
	},
/obj/structure/bed/chair/vehicle{
	pixel_x = 8
	},
/obj/effect/landmark/interior/spawn/telephone{
	pixel_x = 5;
	pixel_y = 30
	},
/obj/structure/extinguisher_cabinet/lifeboat{
	icon = 'icons/obj/vehicles/interiors/general.dmi';
	pixel_x = -8;
	pixel_y = 28
	},
/obj/effect/mapping_helpers/sunlight/pseudo_roof_setter/ship_hull,
/turf/open/shuttle/vehicle{
	icon_state = "floor_3_13"
	},
/area/vehicle/apc/med)
"Y" = (
/obj/structure/interior_wall/apc{
	icon_state = "rear_4"
	},
/obj/effect/mapping_helpers/sunlight/pseudo_roof_setter/ship_hull,
/turf/open/void/vehicle,
/area/space)
"Z" = (
/obj/structure/interior_wall/apc{
	icon_state = "corner_inverse_R";
	opacity = 0
	},
/obj/effect/mapping_helpers/sunlight/pseudo_roof_setter/ship_hull,
/turf/open/void/vehicle,
/area/space)

(1,1,1) = {"
j
N
Y
t
a
e
k
"}
(2,1,1) = {"
n
x
B
J
b
f
k
"}
(3,1,1) = {"
u
M
m
D
c
g
k
"}
(4,1,1) = {"
p
A
O
w
d
h
l
"}
(5,1,1) = {"
P
y
Q
T
Q
K
G
"}
(6,1,1) = {"
q
Z
W
L
V
C
k
"}
(7,1,1) = {"
z
x
E
R
I
H
k
"}
(8,1,1) = {"
s
r
S
v
F
U
k
"}
