//MAP CONVERTED BY dmm2tgm.py THIS HEADER COMMENT PREVENTS RECONVERSION, DO NOT REMOVE
"a" = (
/obj/effect/mapping_helpers/sunlight/pseudo_roof_setter/ship_hull,
/turf/closed/wall/wood,
/area/vehicle/apc)
"b" = (
/obj/effect/mapping_helpers/sunlight/pseudo_roof_setter/ship_hull,
/turf/open/floor/wood,
/area/vehicle/apc)
"c" = (
/obj/effect/landmark/interior/spawn/entrance/step_toward{
	dir = 8;
	exit_type = /obj/structure/interior_exit/fancy
	},
/obj/effect/mapping_helpers/sunlight/pseudo_roof_setter/ship_hull,
/turf/open/floor/wood,
/area/vehicle/apc)
"d" = (
/obj/effect/mapping_helpers/sunlight/pseudo_roof_setter/ship_hull,
/turf/open/floor/carpet{
	icon_state = "carpetside";
	dir = 9
	},
/area/vehicle/apc)
"e" = (
/obj/effect/mapping_helpers/sunlight/pseudo_roof_setter/ship_hull,
/turf/open/floor/carpet{
	icon_state = "carpetside";
	dir = 1
	},
/area/vehicle/apc)
"f" = (
/obj/effect/mapping_helpers/sunlight/pseudo_roof_setter/ship_hull,
/turf/open/floor/carpet{
	icon_state = "carpetside";
	dir = 5
	},
/area/vehicle/apc)
"g" = (
/obj/effect/mapping_helpers/sunlight/pseudo_roof_setter/ship_hull,
/turf/open/floor/carpet{
	icon_state = "carpetside";
	dir = 8
	},
/area/vehicle/apc)
"h" = (
/obj/structure/bed/sofa/south/white/left,
/obj/effect/mapping_helpers/sunlight/pseudo_roof_setter/ship_hull,
/turf/open/floor/carpet,
/area/vehicle/apc)
"i" = (
/obj/structure/bed/sofa/south/white,
/obj/effect/mapping_helpers/sunlight/pseudo_roof_setter/ship_hull,
/turf/open/floor/carpet,
/area/vehicle/apc)
"j" = (
/obj/structure/bed/sofa/south/white/right,
/obj/effect/mapping_helpers/sunlight/pseudo_roof_setter/ship_hull,
/turf/open/floor/carpet,
/area/vehicle/apc)
"k" = (
/obj/effect/mapping_helpers/sunlight/pseudo_roof_setter/ship_hull,
/turf/open/floor/carpet{
	icon_state = "carpetside";
	dir = 4
	},
/area/vehicle/apc)
"l" = (
/obj/structure/surface/table/woodentable/fancy,
/obj/item/device/flashlight/lamp/green,
/obj/effect/mapping_helpers/sunlight/pseudo_roof_setter/ship_hull,
/turf/open/floor/wood,
/area/vehicle/apc)
"m" = (
/obj/effect/mapping_helpers/sunlight/pseudo_roof_setter/ship_hull,
/turf/open/floor/carpet{
	icon_state = "carpetside";
	dir = 10
	},
/area/vehicle/apc)
"n" = (
/obj/effect/mapping_helpers/sunlight/pseudo_roof_setter/ship_hull,
/turf/open/floor/carpet{
	icon_state = "carpetside"
	},
/area/vehicle/apc)
"o" = (
/obj/effect/mapping_helpers/sunlight/pseudo_roof_setter/ship_hull,
/turf/open/floor/carpet{
	icon_state = "carpetside";
	dir = 6
	},
/area/vehicle/apc)
"p" = (
/obj/structure/surface/table/woodentable/fancy,
/obj/effect/mapping_helpers/sunlight/pseudo_roof_setter/ship_hull,
/turf/open/floor/carpet,
/area/vehicle/apc)
"q" = (
/obj/structure/flora/pottedplant{
	icon_state = "pottedplant_10"
	},
/obj/effect/mapping_helpers/sunlight/pseudo_roof_setter/ship_hull,
/turf/open/floor/wood,
/area/vehicle/apc)
"r" = (
/obj/structure/coatrack,
/obj/effect/mapping_helpers/sunlight/pseudo_roof_setter/ship_hull,
/turf/open/floor/wood,
/area/vehicle/apc)
"s" = (
/obj/structure/surface/table/woodentable/fancy,
/obj/structure/machinery/chem_dispenser/soda,
/obj/effect/mapping_helpers/sunlight/pseudo_roof_setter/ship_hull,
/turf/open/floor/wood,
/area/vehicle/apc)
"t" = (
/obj/structure/surface/table/woodentable/fancy,
/obj/structure/machinery/chem_dispenser/soda/beer,
/obj/effect/mapping_helpers/sunlight/pseudo_roof_setter/ship_hull,
/turf/open/floor/wood,
/area/vehicle/apc)
"u" = (
/obj/structure/surface/table/woodentable/fancy,
/obj/item/reagent_container/food/snacks/milosoup{
	pixel_y = 10
	},
/obj/item/reagent_container/food/snacks/meatsteak{
	pixel_y = -2
	},
/obj/structure/machinery/light{
	dir = 1
	},
/obj/effect/mapping_helpers/sunlight/pseudo_roof_setter/ship_hull,
/turf/open/floor/wood,
/area/vehicle/apc)
"v" = (
/obj/structure/surface/table/woodentable/fancy,
/obj/item/reagent_container/food/snacks/appletart,
/obj/effect/mapping_helpers/sunlight/pseudo_roof_setter/ship_hull,
/turf/open/floor/wood,
/area/vehicle/apc)
"w" = (
/obj/structure/surface/table/woodentable/fancy,
/obj/item/reagent_container/food/snacks/popcorn{
	pixel_x = -5;
	pixel_y = 8
	},
/obj/item/reagent_container/food/snacks/sandwich{
	layer = 4;
	pixel_x = 5;
	pixel_y = 6
	},
/obj/item/trash/plate{
	pixel_x = 5
	},
/obj/effect/mapping_helpers/sunlight/pseudo_roof_setter/ship_hull,
/turf/open/floor/wood,
/area/vehicle/apc)
"x" = (
/obj/structure/surface/table/woodentable/fancy,
/obj/item/ashtray/bronze,
/obj/effect/mapping_helpers/sunlight/pseudo_roof_setter/ship_hull,
/turf/open/floor/carpet,
/area/vehicle/apc)
"y" = (
/obj/structure/surface/table/woodentable/fancy,
/obj/item/clothing/mask/cigarette/cigar/cohiba,
/obj/item/tool/lighter/zippo,
/obj/effect/mapping_helpers/sunlight/pseudo_roof_setter/ship_hull,
/turf/open/floor/carpet,
/area/vehicle/apc)
"z" = (
/obj/structure/bed/chair/wood/wings{
	icon_state = "wooden_chair_wings";
	dir = 4
	},
/obj/effect/mapping_helpers/sunlight/pseudo_roof_setter/ship_hull,
/turf/open/floor/wood,
/area/vehicle/apc)
"A" = (
/obj/structure/machinery/disposal,
/obj/effect/mapping_helpers/sunlight/pseudo_roof_setter/ship_hull,
/turf/open/floor/wood,
/area/vehicle/apc)
"B" = (
/obj/structure/machinery/light,
/obj/effect/mapping_helpers/sunlight/pseudo_roof_setter/ship_hull,
/turf/open/floor/carpet{
	icon_state = "carpetside"
	},
/area/vehicle/apc)

(1,1,1) = {"
a
a
b
a
a
a
a
"}
(2,1,1) = {"
a
q
c
r
l
z
a
"}
(3,1,1) = {"
a
A
b
b
b
b
a
"}
(4,1,1) = {"
a
v
d
g
g
m
a
"}
(5,1,1) = {"
a
w
e
h
p
n
a
"}
(6,1,1) = {"
a
u
e
i
x
B
a
"}
(7,1,1) = {"
a
s
e
j
y
n
a
"}
(8,1,1) = {"
a
t
f
k
k
o
a
"}
(9,1,1) = {"
a
a
a
a
a
a
a
"}
