//MAP CONVERTED BY dmm2tgm.py THIS HEADER COMMENT PREVENTS RECONVERSION, DO NOT REMOVE
"ab" = (
/turf/closed/wall/solaris,
/area/bigredv2/outside/building/chapel)
"ac" = (
/obj/structure/window/framed/solaris,
/obj/structure/machinery/door/poddoor/shutters/almayer{
	id = "Chapel";
	name = "\improper Chapel Shutters"
	},
/turf/open/floor/plating,
/area/bigredv2/outside/building/chapel)
"ad" = (
/obj/structure/pipes/standard/simple/hidden/green,
/obj/structure/machinery/door/airlock/multi_tile/almayer/generic{
	name = "\improper Chapel"
	},
/turf/open/floor{
	icon_state = "darkish"
	},
/area/bigredv2/outside/building/chapel)
"ae" = (
/turf/open/floor{
	icon_state = "darkish"
	},
/area/bigredv2/outside/building/chapel)
"af" = (
/obj/structure/closet/wardrobe/chaplain_black,
/turf/open/floor{
	icon_state = "cult"
	},
/area/bigredv2/outside/building/chapel)
"ag" = (
/obj/item/tool/candle,
/turf/open/floor{
	icon_state = "darkish"
	},
/area/bigredv2/outside/building/chapel)
"ah" = (
/obj/effect/decal/cleanable/blood{
	icon_state = "gib6"
	},
/turf/open/floor{
	dir = 1;
	icon_state = "chapel"
	},
/area/bigredv2/outside/building/chapel)
"ai" = (
/obj/effect/decal/cleanable/blood,
/turf/open/floor{
	icon_state = "darkish"
	},
/area/bigredv2/outside/building/chapel)
"ak" = (
/obj/structure/pipes/standard/simple/hidden/green{
	dir = 6
	},
/turf/open/floor{
	icon_state = "darkish"
	},
/area/bigredv2/outside/building/chapel)
"al" = (
/obj/structure/pipes/standard/simple/hidden/green{
	dir = 4
	},
/obj/item/tool/candle,
/turf/open/floor{
	icon_state = "darkish"
	},
/area/bigredv2/outside/building/chapel)
"an" = (
/obj/structure/pipes/standard/simple/hidden/green{
	dir = 9
	},
/obj/effect/decal/cleanable/blood{
	layer = 3;
	pixel_x = 24
	},
/turf/open/floor{
	icon_state = "darkish"
	},
/area/bigredv2/outside/building/chapel)
"ao" = (
/obj/structure/window/framed/solaris,
/obj/structure/machinery/door/poddoor/shutters/almayer{
	dir = 4;
	id = "Chapel";
	name = "\improper Chapel Shutters"
	},
/turf/open/floor/plating,
/area/bigredv2/outside/building/chapel)
"ap" = (
/turf/open/floor{
	icon_state = "cult"
	},
/area/bigredv2/outside/building/chapel)
"aq" = (
/turf/open/floor{
	dir = 1;
	icon_state = "rampbottom"
	},
/area/bigredv2/outside/building/chapel)
"as" = (
/obj/effect/decal/cleanable/blood{
	icon_state = "gib6"
	},
/turf/open/floor{
	dir = 8;
	icon_state = "chapel"
	},
/area/bigredv2/outside/building/chapel)
"at" = (
/obj/structure/bed/chair/wood/normal{
	dir = 8
	},
/obj/effect/decal/cleanable/ash,
/turf/open/floor{
	dir = 4;
	icon_state = "chapel"
	},
/area/bigredv2/outside/building/chapel)
"au" = (
/obj/effect/decal/cleanable/blood/gibs/body,
/turf/open/floor{
	icon_state = "cult"
	},
/area/bigredv2/outside/building/chapel)
"av" = (
/obj/structure/bed/chair/wood/normal{
	dir = 8
	},
/turf/open/floor{
	dir = 4;
	icon_state = "chapel"
	},
/area/bigredv2/outside/building/chapel)
"aw" = (
/obj/structure/bed/chair/wood/normal{
	dir = 8
	},
/obj/effect/decal/cleanable/ash,
/turf/open/floor{
	dir = 1;
	icon_state = "chapel"
	},
/area/bigredv2/outside/building/chapel)
"ax" = (
/obj/structure/bed/chair/wood/normal{
	dir = 8
	},
/obj/structure/pipes/standard/simple/hidden/green,
/turf/open/floor{
	dir = 1;
	icon_state = "chapel"
	},
/area/bigredv2/outside/building/chapel)
"ay" = (
/obj/structure/bed/chair/wood/normal{
	dir = 8
	},
/turf/open/floor{
	dir = 1;
	icon_state = "chapel"
	},
/area/bigredv2/outside/building/chapel)
"az" = (
/obj/item/tool/candle,
/turf/open/floor{
	dir = 1;
	icon_state = "chapel"
	},
/area/bigredv2/outside/building/chapel)
"aA" = (
/turf/open/floor{
	dir = 4;
	icon_state = "chapel"
	},
/area/bigredv2/outside/building/chapel)
"aB" = (
/obj/structure/surface/table/woodentable,
/obj/item/tool/candle,
/turf/open/floor{
	icon_state = "darkish"
	},
/area/bigredv2/outside/building/chapel)
"aC" = (
/obj/item/tool/candle{
	icon_state = "candle2"
	},
/turf/open/floor{
	icon_state = "darkish"
	},
/area/bigredv2/outside/building/chapel)
"aD" = (
/obj/structure/surface/table/woodentable,
/obj/item/weapon/chainofcommand,
/turf/open/floor{
	icon_state = "cult"
	},
/area/bigredv2/outside/building/chapel)
"aE" = (
/obj/structure/pipes/standard/simple/hidden/green{
	dir = 4
	},
/obj/effect/decal/cleanable/blood{
	icon_state = "gib6"
	},
/turf/open/floor{
	icon_state = "darkish"
	},
/area/bigredv2/outside/building/chapel)
"aF" = (
/obj/structure/bed/chair/wood/normal{
	dir = 8
	},
/obj/effect/decal/cleanable/ash,
/turf/open/floor{
	icon_state = "chapel"
	},
/area/bigredv2/outside/building/chapel)
"aG" = (
/obj/structure/bed/chair/wood/normal{
	dir = 8
	},
/obj/effect/decal/cleanable/ash,
/turf/open/floor{
	dir = 8;
	icon_state = "chapel"
	},
/area/bigredv2/outside/building/chapel)
"aH" = (
/obj/structure/bed/chair/wood/normal{
	dir = 8
	},
/turf/open/floor{
	dir = 8;
	icon_state = "chapel"
	},
/area/bigredv2/outside/building/chapel)
"aI" = (
/obj/structure/bed/chair/wood/normal{
	dir = 8
	},
/turf/open/floor{
	icon_state = "chapel"
	},
/area/bigredv2/outside/building/chapel)
"aJ" = (
/obj/structure/pipes/standard/simple/hidden/green,
/obj/structure/bed/chair/wood/normal{
	dir = 8
	},
/turf/open/floor{
	dir = 8;
	icon_state = "chapel"
	},
/area/bigredv2/outside/building/chapel)
"aK" = (
/turf/open/floor{
	dir = 8;
	icon_state = "chapel"
	},
/area/bigredv2/outside/building/chapel)
"aL" = (
/turf/open/floor{
	icon_state = "chapel"
	},
/area/bigredv2/outside/building/chapel)
"aN" = (
/obj/structure/pipes/vents/pump{
	dir = 4
	},
/obj/effect/decal/cleanable/ash,
/obj/effect/decal/cleanable/blood,
/obj/item/clothing/head/cardborg,
/turf/open/floor{
	icon_state = "cult"
	},
/area/bigredv2/outside/building/chapel)
"aO" = (
/obj/structure/pipes/standard/simple/hidden/green{
	dir = 4
	},
/obj/structure/surface/table/woodentable,
/obj/item/storage/bible,
/turf/open/floor{
	icon_state = "cult"
	},
/area/bigredv2/outside/building/chapel)
"aP" = (
/obj/item/tool/candle{
	icon_state = "candle3";
	item_state = "candle3"
	},
/turf/open/floor{
	icon_state = "cult"
	},
/area/bigredv2/outside/building/chapel)
"aR" = (
/obj/item/organ/heart,
/turf/open/floor{
	icon_state = "cult"
	},
/area/bigredv2/outside/building/chapel)
"aS" = (
/obj/structure/pipes/standard/simple/hidden/green{
	dir = 4
	},
/obj/effect/decal/cleanable/blood{
	dir = 4;
	icon_state = "gib6"
	},
/turf/open/floor{
	icon_state = "darkish"
	},
/area/bigredv2/outside/building/chapel)
"aT" = (
/obj/structure/pipes/standard/simple/hidden/green{
	dir = 4
	},
/obj/item/tool/candle{
	icon_state = "candle3"
	},
/turf/open/floor{
	icon_state = "darkish"
	},
/area/bigredv2/outside/building/chapel)
"aU" = (
/obj/structure/pipes/standard/manifold/hidden/green,
/obj/item/tool/candle,
/turf/open/floor{
	icon_state = "darkish"
	},
/area/bigredv2/outside/building/chapel)
"aW" = (
/obj/structure/pipes/standard/simple/hidden/green{
	dir = 4
	},
/turf/open/floor{
	icon_state = "darkish"
	},
/area/bigredv2/outside/building/chapel)
"aX" = (
/obj/structure/pipes/vents/pump{
	dir = 8
	},
/turf/open/floor{
	icon_state = "darkish"
	},
/area/bigredv2/outside/building/chapel)
"aZ" = (
/obj/structure/surface/table/woodentable,
/turf/open/floor{
	icon_state = "cult"
	},
/area/bigredv2/outside/building/chapel)
"ba" = (
/obj/structure/bed/chair/wood/normal{
	dir = 8
	},
/obj/effect/landmark/survivor_spawner,
/turf/open/floor{
	dir = 4;
	icon_state = "chapel"
	},
/area/bigredv2/outside/building/chapel)
"bc" = (
/obj/effect/decal/cleanable/blood{
	layer = 3;
	pixel_x = 24
	},
/turf/open/floor{
	dir = 1;
	icon_state = "chapel"
	},
/area/bigredv2/outside/building/chapel)
"be" = (
/turf/open/floor{
	icon_state = "rampbottom"
	},
/area/bigredv2/outside/building/chapel)
"bh" = (
/obj/item/tool/candle,
/turf/open/floor{
	dir = 8;
	icon_state = "chapel"
	},
/area/bigredv2/outside/building/chapel)
"bi" = (
/obj/item/tool/candle,
/turf/open/floor{
	icon_state = "chapel"
	},
/area/bigredv2/outside/building/chapel)
"bj" = (
/obj/structure/surface/table/woodentable,
/obj/effect/landmark/item_pool_spawner/survivor_ammo/buckshot,
/turf/open/floor{
	icon_state = "darkish"
	},
/area/bigredv2/outside/building/chapel)
"bk" = (
/obj/structure/machinery/door_control{
	id = "Chapel";
	name = "Storm Shutters";
	pixel_x = -32
	},
/obj/effect/decal/cleanable/blood,
/turf/open/floor{
	icon_state = "cult"
	},
/area/bigredv2/outside/building/chapel)
"bl" = (
/obj/structure/machinery/light,
/turf/open/floor{
	icon_state = "darkish"
	},
/area/bigredv2/outside/building/chapel)
"bm" = (
/obj/structure/machinery/power/apc,
/obj/effect/decal/cleanable/blood{
	icon_state = "gib6"
	},
/turf/open/floor{
	icon_state = "darkish"
	},
/area/bigredv2/outside/building/chapel)
"bp" = (
/obj/structure/machinery/alarm{
	dir = 1;
	pixel_y = -30
	},
/turf/open/floor{
	icon_state = "darkish"
	},
/area/bigredv2/outside/building/chapel)
"bq" = (
/obj/item/tool/candle{
	icon_state = "candle4"
	},
/turf/open/floor{
	icon_state = "cult"
	},
/area/bigredv2/outside/building/chapel)

(1,1,1) = {"
ab
ab
ao
ao
ao
ao
ao
ab
ab
"}
(2,1,1) = {"
ab
af
ap
aP
aR
bq
ap
bk
ab
"}
(3,1,1) = {"
ac
ae
aq
au
aN
au
be
ae
ab
"}
(4,1,1) = {"
ac
ae
aZ
aD
aO
aZ
aZ
ae
ab
"}
(5,1,1) = {"
ab
aC
ah
as
aE
ah
as
bl
ab
"}
(6,1,1) = {"
ac
ag
at
aF
aW
at
aF
ae
ab
"}
(7,1,1) = {"
ac
ae
ay
aG
aT
ay
aG
ae
ab
"}
(8,1,1) = {"
ab
ae
av
aF
aS
ba
aI
ae
ab
"}
(9,1,1) = {"
ac
ai
aw
aH
aW
ay
aH
ae
ab
"}
(10,1,1) = {"
ac
ae
av
aI
aW
at
aF
bm
ab
"}
(11,1,1) = {"
ab
ak
ax
aJ
aU
ay
aH
ae
ab
"}
(12,1,1) = {"
ac
al
av
aI
aS
av
aI
aC
ab
"}
(13,1,1) = {"
ac
al
ay
aH
aW
ay
aH
ag
ab
"}
(14,1,1) = {"
ab
aW
av
aI
aW
av
aI
bl
ab
"}
(15,1,1) = {"
ad
an
az
aK
aS
bc
bh
ae
ab
"}
(16,1,1) = {"
ae
ae
aA
aL
aX
aA
bi
ae
ab
"}
(17,1,1) = {"
ab
ae
aB
aB
ae
bj
bj
bp
ab
"}
